date,dbl_hdr,hm_tm,vis_runs,hm_runs,attendance,duration,score_diff,wl
1912-04-20,0,BOS,6,7,24000,190,1,W
1912-04-23,0,BOS,6,2,2500,145,-4,NW
1912-04-24,0,BOS,5,2,2500,135,-3,NW
1912-04-25,0,BOS,1,4,3000,118,3,W
1912-04-26,0,BOS,6,7,10000,125,1,W
1912-04-27,0,BOS,5,6,15000,102,1,W
1912-04-29,0,BOS,7,1,3500,120,-6,NW
1912-04-30,0,BOS,1,6,4000,112,5,W
1912-05-07,0,BOS,4,5,4500,102,1,W
1912-05-09,0,BOS,4,7,4500,119,3,W
1912-05-10,0,BOS,6,5,4500,140,-1,NW
1912-05-11,0,BOS,1,8,12000,120,7,W
1912-05-13,0,BOS,9,14,3000,136,5,W
1912-05-14,0,BOS,5,6,2500,127,1,W
1912-05-15,0,BOS,1,2,2000,100,1,W
1912-05-17,0,BOS,5,2,18000,132,-3,NW
1912-05-18,0,BOS,3,1,20000,119,-2,NW
1912-05-20,0,BOS,0,2,4500,114,2,W
1912-05-21,0,BOS,1,3,4500,98,2,W
1912-05-22,0,BOS,0,9,5000,86,9,W
1912-05-23,0,BOS,5,6,4000,137,1,W
1912-05-24,0,BOS,3,4,7500,109,1,W
1912-05-25,0,BOS,8,2,15000,118,-6,NW
1912-05-27,0,BOS,12,6,5000,142,-6,NW
1912-05-28,0,BOS,3,7,3500,118,4,W
1912-05-29,1,BOS,8,21,0,130,13,W
1912-05-29,2,BOS,11,12,7500,143,1,W
1912-05-30,1,BOS,2,3,5000,120,1,W
1912-05-30,2,BOS,5,0,9000,118,-5,NW
1912-06-28,1,BOS,4,5,0,114,1,W
1912-06-28,2,BOS,4,6,15000,115,2,W
1912-06-29,1,BOS,6,13,0,120,7,W
1912-06-29,2,BOS,0,6,20000,80,6,W
1912-07-01,0,BOS,1,4,3500,109,3,W
1912-07-02,0,BOS,9,7,4000,110,-2,NW
1912-07-08,0,BOS,1,5,4000,122,4,W
1912-07-09,0,BOS,2,3,3000,130,1,W
1912-07-10,0,BOS,9,2,4000,113,-7,NW
1912-07-12,1,BOS,1,4,0,110,3,W
1912-07-12,2,BOS,0,1,15000,113,1,W
1912-07-13,0,BOS,0,4,20000,108,4,W
1912-07-15,0,BOS,6,4,8500,125,-2,NW
1912-07-16,0,BOS,2,7,7000,95,5,W
1912-07-17,1,BOS,1,0,0,115,-1,NW
1912-07-17,2,BOS,3,7,21000,118,4,W
1912-07-19,1,BOS,0,8,16000,102,8,W
1912-07-19,2,BOS,1,2,NA,145,1,W
1912-07-20,0,BOS,2,3,22000,120,1,W
1912-07-22,0,BOS,3,8,6000,120,5,W
1912-07-23,0,BOS,3,6,5500,121,3,W
1912-07-24,0,BOS,11,6,7000,135,-5,NW
1912-07-25,0,BOS,1,0,9000,92,-1,NW
1912-08-14,1,BOS,2,8,0,140,6,W
1912-08-14,2,BOS,0,8,18000,85,8,W
1912-08-15,0,BOS,6,13,8000,115,7,W
1912-08-16,0,BOS,3,2,6000,138,-1,NW
1912-08-17,0,BOS,4,6,26050,127,2,W
1912-08-19,0,BOS,3,4,12000,109,1,W
1912-08-20,0,BOS,2,6,8000,104,4,W
1912-08-21,0,BOS,9,4,8000,123,-5,NW
1912-08-22,0,BOS,0,9,10000,110,9,W
1912-08-23,0,BOS,1,5,5000,115,4,W
1912-08-24,0,BOS,4,8,22000,128,4,W
1912-08-26,0,BOS,4,2,6000,113,-2,NW
1912-08-27,0,BOS,8,8,7000,203,0,NW
1912-08-28,1,BOS,3,5,0,110,2,W
1912-08-28,2,BOS,0,3,20000,88,3,W
1912-08-29,0,BOS,1,8,14000,131,7,W
1912-08-30,0,BOS,4,7,10000,142,3,W
1912-08-31,0,BOS,1,2,30000,116,1,W
1912-09-04,0,BOS,2,6,18000,124,4,W
1912-09-05,0,BOS,3,4,15000,123,1,W
1912-09-06,0,BOS,0,1,29000,110,1,W
1912-09-07,0,BOS,5,1,23000,125,-4,NW
1912-09-24,1,BOS,5,2,0,127,-3,NW
1912-09-24,2,BOS,1,3,7500,106,2,W
1912-09-25,0,BOS,0,6,4000,79,6,W
1912-09-26,0,BOS,12,15,5000,135,3,W
1913-04-10,0,BOS,10,9,20000,142,-1,NW
1913-04-12,0,BOS,5,4,4000,155,-1,NW
1913-04-14,0,BOS,1,2,6000,118,1,W
1913-04-15,0,BOS,3,2,3500,104,-1,NW
1913-05-01,0,BOS,2,8,8000,142,6,W
1913-05-02,0,BOS,5,4,7500,118,-1,NW
1913-05-03,0,BOS,2,1,20000,142,-1,NW
1913-05-05,0,BOS,5,3,11000,150,-2,NW
1913-06-03,0,BOS,2,3,14000,111,1,W
1913-06-04,0,BOS,4,1,7500,110,-3,NW
1913-06-05,0,BOS,5,0,5500,98,-5,NW
1913-06-06,0,BOS,3,4,4500,139,1,W
1913-06-09,0,BOS,1,4,7500,105,3,W
1913-06-10,0,BOS,3,7,7000,120,4,W
1913-06-11,0,BOS,9,5,7500,200,-4,NW
1913-06-12,0,BOS,2,3,5000,120,1,W
1913-06-13,0,BOS,6,7,5000,210,1,W
1913-06-14,0,BOS,1,8,12000,100,7,W
1913-06-16,0,BOS,2,3,4000,140,1,W
1913-06-17,1,BOS,4,7,6800,130,3,W
1913-06-17,2,BOS,4,3,16000,120,-1,NW
1913-06-18,0,BOS,6,7,6500,107,1,W
1913-06-19,0,BOS,4,5,4000,116,1,W
1913-06-25,0,BOS,5,2,6500,117,-3,NW
1913-06-27,1,BOS,3,10,0,123,7,W
1913-06-27,2,BOS,4,6,11000,135,2,W
1913-06-28,1,BOS,6,9,0,125,3,W
1913-06-28,2,BOS,7,6,15500,120,-1,NW
1913-06-30,0,BOS,3,1,6000,125,-2,NW
1913-07-01,0,BOS,7,4,4000,117,-3,NW
1913-07-02,0,BOS,5,0,4000,120,-5,NW
1913-07-03,0,BOS,1,0,4000,155,-1,NW
1913-07-04,1,BOS,6,13,9000,135,7,W
1913-07-04,2,BOS,5,3,15000,126,-2,NW
1913-07-05,0,BOS,7,6,13000,117,-1,NW
1913-07-07,1,BOS,7,4,0,105,-3,NW
1913-07-07,2,BOS,3,8,14000,133,5,W
1913-07-25,0,BOS,5,7,5000,120,2,W
1913-07-26,0,BOS,1,4,12000,105,3,W
1913-07-29,1,BOS,0,2,0,102,2,W
1913-07-29,2,BOS,3,5,12000,133,2,W
1913-07-31,1,BOS,5,2,0,125,-3,NW
1913-07-31,2,BOS,4,2,13000,123,-2,NW
1913-08-01,0,BOS,6,2,6000,125,-4,NW
1913-08-02,1,BOS,5,4,0,125,-1,NW
1913-08-02,2,BOS,7,0,15000,117,-7,NW
1913-08-05,1,BOS,0,3,0,95,3,W
1913-08-05,2,BOS,4,2,7000,106,-2,NW
1913-08-06,0,BOS,1,4,3000,105,3,W
1913-08-07,0,BOS,8,9,3000,125,1,W
1913-08-08,0,BOS,4,5,5000,117,1,W
1913-08-09,0,BOS,6,3,11300,115,-3,NW
1913-08-11,0,BOS,6,2,3000,112,-4,NW
1913-08-28,0,BOS,0,1,10500,113,1,W
1913-08-30,1,BOS,4,1,0,102,-3,NW
1913-08-30,2,BOS,4,0,15000,120,-4,NW
1913-09-01,1,BOS,0,6,5000,118,6,W
1913-09-01,2,BOS,3,4,11000,140,1,W
1913-09-02,0,BOS,2,4,3000,114,2,W
1913-09-03,0,BOS,11,4,3000,120,-7,NW
1913-09-09,0,BOS,2,3,3500,148,1,W
1913-09-10,0,BOS,2,4,8000,101,2,W
1913-09-11,0,BOS,15,2,3000,120,-13,NW
1913-09-12,0,BOS,5,18,2500,117,13,W
1913-09-13,0,BOS,2,3,4500,112,1,W
1913-09-15,0,BOS,3,6,3000,100,3,W
1913-09-16,0,BOS,4,5,2000,135,1,W
1913-09-17,0,BOS,2,0,3000,115,-2,NW
1913-09-18,0,BOS,4,5,2500,120,1,W
1913-09-23,1,BOS,2,3,0,95,1,W
1913-09-23,2,BOS,3,2,5100,100,-1,NW
1913-09-24,0,BOS,10,9,3000,130,-1,NW
1913-09-25,0,BOS,4,5,3000,115,1,W
1913-09-26,0,BOS,4,10,2900,115,6,W
1913-09-27,0,BOS,3,5,7000,85,2,W
1914-04-14,0,BOS,3,0,24741,105,-3,NW
1914-04-15,0,BOS,1,2,1406,115,1,W
1914-04-17,0,BOS,1,0,5097,115,-1,NW
1914-04-18,0,BOS,0,1,16000,112,1,W
1914-04-20,1,BOS,8,2,12979,137,-6,NW
1914-04-20,2,BOS,6,0,NA,115,-6,NW
1914-04-21,0,BOS,1,1,NA,167,0,NW
1914-04-22,0,BOS,9,9,NA,140,0,NW
1914-05-07,0,BOS,0,2,3500,111,2,W
1914-05-08,0,BOS,0,3,1000,115,3,W
1914-05-09,0,BOS,3,2,12000,105,-1,NW
1914-05-11,0,BOS,6,2,5000,116,-4,NW
1914-05-12,0,BOS,0,7,NA,100,7,W
1914-05-14,0,BOS,0,1,NA,119,1,W
1914-05-15,0,BOS,9,3,NA,117,-6,NW
1914-05-16,0,BOS,0,3,14699,110,3,W
1914-05-18,0,BOS,0,2,NA,110,2,W
1914-05-19,0,BOS,4,6,NA,105,2,W
1914-05-20,0,BOS,3,0,NA,95,-3,NW
1914-05-21,0,BOS,5,2,NA,107,-3,NW
1914-05-22,0,BOS,0,1,NA,85,1,W
1914-05-23,0,BOS,2,6,NA,130,4,W
1914-05-25,0,BOS,3,0,3847,89,-3,NW
1914-05-26,0,BOS,3,2,4844,134,-1,NW
1914-05-27,0,BOS,4,5,4000,107,1,W
1914-05-28,0,BOS,5,2,4101,125,-3,NW
1914-05-29,1,BOS,1,0,NA,105,-1,NW
1914-05-29,2,BOS,5,6,NA,165,1,W
1914-05-30,1,BOS,6,4,8132,145,-2,NW
1914-05-30,2,BOS,2,7,NA,110,5,W
1914-06-01,0,BOS,0,1,NA,95,1,W
1914-06-02,1,BOS,2,3,NA,116,1,W
1914-06-02,2,BOS,4,2,NA,112,-2,NW
1914-06-03,1,BOS,10,1,NA,110,-9,NW
1914-06-03,2,BOS,7,5,NA,140,-2,NW
1914-07-08,1,BOS,4,2,0,135,-2,NW
1914-07-08,2,BOS,5,4,18536,108,-1,NW
1914-07-09,0,BOS,3,2,NA,106,-1,NW
1914-07-10,0,BOS,1,5,NA,108,4,W
1914-07-11,0,BOS,3,4,NA,93,1,W
1914-07-13,0,BOS,0,2,NA,116,2,W
1914-07-14,0,BOS,1,2,NA,107,1,W
1914-07-15,0,BOS,0,4,NA,105,4,W
1914-07-16,0,BOS,5,2,NA,117,-3,NW
1914-07-17,0,BOS,2,8,NA,112,6,W
1914-07-18,0,BOS,4,2,NA,180,-2,NW
1914-07-20,0,BOS,2,3,NA,190,1,W
1914-07-21,0,BOS,1,1,11611,70,0,NW
1914-07-22,1,BOS,3,5,NA,125,2,W
1914-07-22,2,BOS,2,6,NA,120,4,W
1914-08-13,0,BOS,1,0,7000,102,-1,NW
1914-08-14,0,BOS,7,6,6000,142,-1,NW
1914-08-15,0,BOS,0,1,8000,122,1,W
1914-08-19,1,BOS,1,3,NA,95,2,W
1914-08-19,2,BOS,1,4,NA,115,3,W
1914-08-20,0,BOS,2,3,3844,105,1,W
1914-08-22,0,BOS,2,4,11748,105,2,W
1914-08-24,0,BOS,3,7,NA,120,4,W
1914-08-25,0,BOS,3,1,NA,99,-2,NW
1914-08-26,0,BOS,2,5,NA,110,3,W
1914-08-27,0,BOS,2,9,NA,110,7,W
1914-08-28,0,BOS,3,0,NA,112,-3,NW
1914-08-31,1,BOS,1,4,NA,93,3,W
1914-08-31,2,BOS,3,3,NA,178,0,NW
1914-09-01,1,BOS,6,7,NA,128,1,W
1914-09-01,2,BOS,2,4,NA,120,2,W
1914-09-02,1,BOS,9,6,NA,145,-3,NW
1914-09-02,2,BOS,3,7,NA,95,4,W
1914-09-03,1,BOS,1,3,0,104,2,W
1914-09-03,2,BOS,3,6,17628,123,3,W
1914-09-04,0,BOS,2,4,NA,107,2,W
1914-09-05,0,BOS,1,4,15380,117,3,W
1914-10-01,1,BOS,5,3,0,115,-2,NW
1914-10-01,2,BOS,2,4,7120,100,2,W
1914-10-02,0,BOS,5,11,NA,114,6,W
1914-10-03,0,BOS,3,2,NA,114,-1,NW
1914-10-05,0,BOS,9,3,NA,115,-6,NW
1914-10-06,0,BOS,4,8,NA,100,4,W
1914-10-07,0,BOS,11,4,NA,78,-7,NW
1915-04-22,0,BOS,6,7,10937,155,1,W
1915-04-24,0,BOS,6,3,5360,120,-3,NW
1915-04-26,0,BOS,2,9,3813,105,7,W
1915-04-27,0,BOS,2,0,NA,99,-2,NW
1915-04-29,0,BOS,6,4,NA,136,-2,NW
1915-05-04,0,BOS,0,2,4327,99,2,W
1915-05-05,0,BOS,0,1,2671,101,1,W
1915-06-04,0,BOS,2,0,5311,102,-2,NW
1915-06-05,0,BOS,2,4,10849,110,2,W
1915-06-07,0,BOS,0,3,3051,88,3,W
1915-06-08,0,BOS,4,3,2809,116,-1,NW
1915-06-09,0,BOS,15,0,9551,125,-15,NW
1915-06-10,0,BOS,5,6,7413,135,1,W
1915-06-11,0,BOS,3,4,8614,115,1,W
1915-06-12,0,BOS,4,5,10078,117,1,W
1915-06-14,0,BOS,1,4,3866,106,3,W
1915-06-16,0,BOS,3,4,4066,104,1,W
1915-06-17,0,BOS,10,11,4918,140,1,W
1915-06-18,0,BOS,1,3,4694,118,2,W
1915-06-19,0,BOS,5,5,9674,141,0,NW
1915-06-25,0,BOS,5,9,6300,115,4,W
1915-06-26,1,BOS,5,1,12000,120,-4,NW
1915-06-26,2,BOS,2,4,NA,103,2,W
1915-06-28,1,BOS,3,2,10552,98,-1,NW
1915-06-28,2,BOS,3,6,NA,118,3,W
1915-06-29,0,BOS,3,4,NA,142,1,W
1915-06-30,1,BOS,5,10,0,135,5,W
1915-06-30,2,BOS,7,10,5879,128,3,W
1915-07-03,1,BOS,7,3,0,135,-4,NW
1915-07-03,2,BOS,0,11,11529,118,11,W
1915-07-05,1,BOS,0,4,NA,NA,4,W
1915-07-05,2,BOS,0,6,7133,118,6,W
1915-07-06,1,BOS,1,5,NA,107,4,W
1915-07-06,2,BOS,1,4,12331,97,3,W
1915-07-07,1,BOS,4,9,0,120,5,W
1915-07-07,2,BOS,0,1,14024,107,1,W
1915-07-27,0,BOS,1,3,NA,101,2,W
1915-07-28,0,BOS,1,0,NA,111,-1,NW
1915-07-30,0,BOS,7,6,12655,135,-1,NW
1915-07-31,0,BOS,1,4,20884,101,3,W
1915-08-02,0,BOS,5,3,11014,105,-2,NW
1915-08-03,0,BOS,1,2,11315,112,1,W
1915-08-07,1,BOS,0,2,0,105,2,W
1915-08-07,2,BOS,2,6,20207,110,4,W
1915-08-09,0,BOS,0,2,10000,105,2,W
1915-08-10,1,BOS,3,2,NA,111,-1,NW
1915-08-10,2,BOS,3,10,8834,112,7,W
1915-08-11,1,BOS,3,11,0,116,8,W
1915-08-11,2,BOS,1,2,10423,112,1,W
1915-08-12,0,BOS,0,4,5000,110,4,W
1915-08-13,0,BOS,2,3,5936,102,1,W
1915-08-14,0,BOS,3,4,15612,105,1,W
1915-08-16,0,BOS,0,1,7119,88,1,W
1915-09-06,1,BOS,4,0,13799,97,-4,NW
1915-09-06,2,BOS,5,2,NA,125,-3,NW
1915-09-07,0,BOS,8,3,NA,107,-5,NW
1915-09-08,1,BOS,1,0,NA,95,-1,NW
1915-09-08,2,BOS,2,13,NA,106,11,W
1915-09-09,0,BOS,0,5,5272,114,5,W
1915-09-10,0,BOS,2,7,NA,101,5,W
1915-09-11,0,BOS,4,5,16309,161,1,W
1915-09-13,1,BOS,1,2,0,115,1,W
1915-09-13,2,BOS,1,4,15851,100,3,W
1915-09-14,0,BOS,1,2,4155,105,1,W
1915-09-15,0,BOS,3,1,5000,128,-2,NW
1915-09-16,0,BOS,6,1,21897,120,-5,NW
1915-09-17,0,BOS,2,7,NA,118,5,W
1915-09-18,0,BOS,0,1,37528,147,1,W
1915-09-20,0,BOS,2,3,27000,128,1,W
1915-09-22,1,BOS,2,3,0,127,1,W
1915-09-22,2,BOS,1,7,5360,96,6,W
1915-09-23,1,BOS,4,5,0,123,1,W
1915-09-23,2,BOS,2,6,5813,94,4,W
1915-09-24,0,BOS,8,4,2818,125,-4,NW
1915-09-25,0,BOS,2,3,6595,115,1,W
1915-09-27,0,BOS,4,8,2533,138,4,W
1916-04-12,0,BOS,1,2,6000,117,1,W
1916-04-13,0,BOS,2,8,2714,122,6,W
1916-04-15,0,BOS,1,2,NA,117,1,W
1916-04-17,0,BOS,1,5,3132,110,4,W
1916-04-18,0,BOS,4,2,1407,110,-2,NW
1916-04-19,1,BOS,3,2,0,NA,-1,NW
1916-04-19,2,BOS,0,2,21997,116,2,W
1916-05-04,0,BOS,0,3,4978,NA,3,W
1916-05-05,0,BOS,8,4,2677,176,-4,NW
1916-05-06,0,BOS,5,4,8402,NA,-1,NW
1916-05-08,0,BOS,4,0,3581,NA,-4,NW
1916-05-09,0,BOS,1,5,14353,102,4,W
1916-05-10,0,BOS,6,2,4073,103,-4,NW
1916-05-11,0,BOS,5,6,6572,135,1,W
1916-05-12,0,BOS,3,1,4586,122,-2,NW
1916-05-13,0,BOS,2,3,10717,155,1,W
1916-05-18,0,BOS,7,1,2128,103,-6,NW
1916-05-19,0,BOS,5,1,2074,130,-4,NW
1916-05-20,0,BOS,1,3,5232,136,2,W
1916-05-22,0,BOS,1,2,5708,134,1,W
1916-05-24,0,BOS,0,4,6081,105,4,W
1916-05-25,0,BOS,2,5,6872,110,3,W
1916-05-30,1,BOS,3,4,4998,144,1,W
1916-05-30,2,BOS,2,8,14903,115,6,W
1916-05-31,0,BOS,1,10,3281,133,9,W
1916-06-01,0,BOS,0,1,7934,95,1,W
1916-06-20,0,BOS,4,1,3946,NA,-3,NW
1916-06-21,0,BOS,0,2,4523,NA,2,W
1916-06-22,0,BOS,0,1,3889,NA,1,W
1916-06-23,0,BOS,0,1,4080,90,1,W
1916-06-24,1,BOS,2,3,NA,120,1,W
1916-06-24,2,BOS,3,7,NA,100,4,W
1916-06-26,0,BOS,8,5,3812,135,-3,NW
1916-06-27,0,BOS,2,7,3523,100,5,W
1916-07-06,0,BOS,5,6,8773,135,1,W
1916-07-07,0,BOS,1,2,6777,117,1,W
1916-07-08,0,BOS,5,1,15122,112,-4,NW
1916-07-10,1,BOS,4,0,0,101,-4,NW
1916-07-10,2,BOS,3,0,7042,82,-3,NW
1916-07-11,1,BOS,3,5,0,131,2,W
1916-07-11,2,BOS,1,3,6903,104,2,W
1916-07-12,1,BOS,1,2,0,90,1,W
1916-07-12,2,BOS,1,3,8409,110,2,W
1916-07-14,0,BOS,0,0,4480,220,0,NW
1916-07-15,1,BOS,2,1,NA,120,-1,NW
1916-07-15,2,BOS,4,17,18047,124,13,W
1916-07-17,0,BOS,2,3,2705,111,1,W
1916-07-18,0,BOS,3,4,3988,150,1,W
1916-07-19,1,BOS,2,4,0,125,2,W
1916-07-19,2,BOS,5,9,18384,124,4,W
1916-07-20,0,BOS,3,2,5894,158,-1,NW
1916-07-22,1,BOS,4,3,0,92,-1,NW
1916-07-22,2,BOS,0,1,26162,96,1,W
1916-08-12,0,BOS,1,2,16557,130,1,W
1916-08-14,0,BOS,2,1,6456,113,-1,NW
1916-08-15,0,BOS,0,1,5467,157,1,W
1916-08-16,1,BOS,4,5,0,233,1,W
1916-08-16,2,BOS,1,2,25227,62,1,W
1916-08-17,0,BOS,7,0,6416,101,-7,NW
1916-08-18,0,BOS,11,6,5586,115,-5,NW
1916-08-19,0,BOS,1,2,18000,115,1,W
1916-08-21,0,BOS,0,4,9744,100,4,W
1916-08-22,0,BOS,0,3,5881,97,3,W
1916-08-23,0,BOS,3,7,5600,125,4,W
1916-08-24,0,BOS,0,3,4500,105,3,W
1916-08-25,0,BOS,2,1,7984,112,-1,NW
1916-08-26,0,BOS,2,1,23000,110,-1,NW
1916-08-29,1,BOS,5,3,0,128,-2,NW
1916-08-29,2,BOS,8,2,18000,128,-6,NW
1916-08-30,0,BOS,0,4,8246,95,4,W
1916-08-31,0,BOS,2,1,7968,103,-1,NW
1916-09-27,0,BOS,2,3,10896,NA,1,W
1916-09-28,0,BOS,4,2,10918,NA,-2,NW
1916-09-29,0,BOS,0,3,8801,NA,3,W
1916-09-30,0,BOS,0,1,14573,NA,1,W
1916-10-02,0,BOS,2,4,3641,76,2,W
1916-10-03,1,BOS,5,3,0,110,-2,NW
1916-10-03,2,BOS,7,5,4800,105,-2,NW
1917-04-21,0,BOS,4,6,6387,100,2,W
1917-04-23,0,BOS,9,6,7247,141,-3,NW
1917-04-24,0,BOS,2,1,3219,121,-1,NW
1917-04-25,0,BOS,4,5,3570,127,1,W
1917-04-28,0,BOS,1,7,7654,100,6,W
1917-04-30,0,BOS,3,6,2049,108,3,W
1917-05-03,0,BOS,0,2,1805,102,2,W
1917-05-31,0,BOS,1,5,5226,117,4,W
1917-06-01,0,BOS,3,0,3671,113,-3,NW
1917-06-02,0,BOS,5,0,6038,105,-5,NW
1917-06-04,0,BOS,1,2,7349,92,1,W
1917-06-05,0,BOS,4,11,10024,125,7,W
1917-06-06,0,BOS,3,0,7153,118,-3,NW
1917-06-08,0,BOS,7,4,3672,125,-3,NW
1917-06-09,0,BOS,1,0,15103,110,-1,NW
1917-06-13,1,BOS,0,2,0,118,2,W
1917-06-13,2,BOS,7,2,3331,115,-5,NW
1917-06-14,0,BOS,3,0,4361,96,-3,NW
1917-06-15,0,BOS,8,0,4535,125,-8,NW
1917-06-16,0,BOS,7,2,9405,124,-5,NW
1917-06-18,1,BOS,4,6,7049,137,2,W
1917-06-18,2,BOS,7,8,16822,140,1,W
1917-06-23,1,BOS,0,4,0,100,4,W
1917-06-23,2,BOS,0,5,16158,118,5,W
1917-06-25,1,BOS,4,0,0,88,-4,NW
1917-06-25,2,BOS,3,4,6553,100,1,W
1917-06-26,0,BOS,3,2,2788,120,-1,NW
1917-06-27,0,BOS,7,6,3932,165,-1,NW
1917-06-28,1,BOS,2,3,8500,120,1,W
1917-06-28,2,BOS,0,5,8020,102,5,W
1917-06-29,0,BOS,1,2,3183,118,1,W
1917-06-30,0,BOS,2,9,11452,115,7,W
1917-07-02,0,BOS,4,4,10100,162,0,NW
1917-07-03,1,BOS,3,0,NA,95,-3,NW
1917-07-03,2,BOS,1,6,5693,112,5,W
1917-07-04,1,BOS,3,6,5783,103,3,W
1917-07-04,2,BOS,2,6,14400,92,4,W
1917-07-05,1,BOS,3,4,NA,106,1,W
1917-07-05,2,BOS,2,4,6364,105,2,W
1917-07-25,0,BOS,4,5,5486,112,1,W
1917-07-26,1,BOS,2,11,0,135,9,W
1917-07-26,2,BOS,3,8,6745,100,5,W
1917-07-28,1,BOS,2,3,0,156,1,W
1917-07-28,2,BOS,2,3,15277,98,1,W
1917-07-30,0,BOS,1,3,11151,115,2,W
1917-07-31,0,BOS,2,5,11501,118,3,W
1917-08-01,0,BOS,4,0,11800,121,-4,NW
1917-08-02,0,BOS,7,1,10451,133,-6,NW
1917-08-03,0,BOS,2,1,5411,97,-1,NW
1917-08-04,0,BOS,2,3,9806,147,1,W
1917-08-06,0,BOS,2,0,7771,118,-2,NW
1917-08-07,0,BOS,6,8,5041,133,2,W
1917-08-08,0,BOS,6,2,9227,110,-4,NW
1917-08-10,1,BOS,4,5,NA,125,1,W
1917-08-10,2,BOS,1,5,8873,119,4,W
1917-08-11,1,BOS,2,7,0,115,5,W
1917-08-11,2,BOS,5,0,29052,117,-5,NW
1917-08-30,0,BOS,1,1,5384,NA,0,NW
1917-08-31,1,BOS,3,5,0,100,2,W
1917-08-31,2,BOS,2,6,3500,101,4,W
1917-09-01,0,BOS,1,6,2861,NA,5,W
1917-09-03,1,BOS,1,0,NA,NA,-1,NW
1917-09-03,2,BOS,4,1,25545,98,-3,NW
1917-09-04,1,BOS,2,4,0,80,2,W
1917-09-04,2,BOS,7,3,7121,113,-4,NW
1917-09-19,1,BOS,5,2,NA,118,-3,NW
1917-09-19,2,BOS,1,0,9830,80,-1,NW
1917-09-20,0,BOS,1,0,4380,104,-1,NW
1917-09-21,0,BOS,2,1,4953,108,-1,NW
1917-09-22,0,BOS,1,4,8495,87,3,W
1917-09-24,0,BOS,0,3,2254,97,3,W
1917-09-25,0,BOS,3,4,2033,156,1,W
1917-09-26,0,BOS,2,0,3080,90,-2,NW
1917-09-28,0,BOS,2,1,356,84,-1,NW
1917-09-29,1,BOS,5,13,0,120,8,W
1917-09-29,2,BOS,0,11,3292,87,11,W
1917-10-02,1,BOS,9,7,NA,139,-2,NW
1917-10-02,2,BOS,1,2,1892,79,1,W
1917-10-03,0,BOS,6,0,2070,100,-6,NW
1917-10-04,0,BOS,5,4,399,86,-1,NW
1918-04-15,0,BOS,1,7,7180,108,6,W
1918-04-16,0,BOS,0,1,2515,89,1,W
1918-04-17,0,BOS,4,5,5000,125,1,W
1918-04-19,1,BOS,1,2,3812,124,1,W
1918-04-19,2,BOS,5,9,12336,130,4,W
1918-04-20,0,BOS,3,4,4470,111,1,W
1918-04-22,0,BOS,11,4,2130,115,-7,NW
1918-04-23,0,BOS,0,1,2960,105,1,W
1918-04-30,0,BOS,1,8,3365,105,7,W
1918-05-01,0,BOS,5,0,2159,101,-5,NW
1918-05-02,0,BOS,1,8,2725,110,7,W
1918-05-10,0,BOS,1,4,2613,102,3,W
1918-05-11,0,BOS,4,2,7046,114,-2,NW
1918-05-13,0,BOS,5,7,2846,140,2,W
1918-05-15,0,BOS,4,5,4816,105,1,W
1918-05-16,0,BOS,2,7,4250,102,5,W
1918-05-17,0,BOS,8,11,4188,125,3,W
1918-05-18,0,BOS,1,3,10230,65,2,W
1918-05-20,0,BOS,1,11,4861,110,10,W
1918-05-21,0,BOS,6,5,1960,124,-1,NW
1918-05-23,0,BOS,1,0,3655,112,-1,NW
1918-05-24,0,BOS,4,5,3725,124,1,W
1918-05-25,0,BOS,2,3,10255,118,1,W
1918-05-27,0,BOS,6,4,4282,125,-2,NW
1918-05-28,0,BOS,0,1,2975,90,1,W
1918-05-29,1,BOS,2,4,0,97,2,W
1918-05-29,2,BOS,0,3,3225,100,3,W
1918-05-30,1,BOS,1,9,1988,119,8,W
1918-05-30,2,BOS,4,0,10161,90,-4,NW
1918-06-19,0,BOS,5,0,3070,113,-5,NW
1918-06-20,1,BOS,2,0,0,97,-2,NW
1918-06-20,2,BOS,0,3,5540,106,3,W
1918-06-21,0,BOS,0,13,2037,100,13,W
1918-07-06,0,BOS,4,5,5250,129,1,W
1918-07-08,1,BOS,0,1,0,92,1,W
1918-07-08,2,BOS,4,3,8309,118,-1,NW
1918-07-09,0,BOS,0,1,4117,105,1,W
1918-07-10,0,BOS,0,2,5120,55,2,W
1918-07-11,0,BOS,0,4,4522,84,4,W
1918-07-12,0,BOS,3,6,4255,80,3,W
1918-07-13,0,BOS,5,0,9529,109,-5,NW
1918-07-15,0,BOS,1,3,3514,89,2,W
1918-07-16,0,BOS,1,2,4093,110,1,W
1918-07-17,1,BOS,0,7,0,105,7,W
1918-07-17,2,BOS,0,4,8290,70,4,W
1918-07-18,0,BOS,6,3,3238,110,-3,NW
1918-07-19,0,BOS,0,5,5410,100,5,W
1918-07-20,0,BOS,1,5,13525,97,4,W
1918-07-22,1,BOS,0,1,0,NA,1,W
1918-07-22,2,BOS,0,3,10592,NA,3,W
1918-08-10,1,BOS,5,1,0,NA,-4,NW
1918-08-10,2,BOS,4,1,7800,NA,-3,NW
1918-08-12,0,BOS,2,1,2786,96,-1,NW
1918-08-14,0,BOS,3,5,2861,110,2,W
1918-08-15,0,BOS,6,2,3040,105,-4,NW
1918-08-16,0,BOS,0,2,NA,75,2,W
1918-08-17,0,BOS,2,4,15129,105,2,W
1918-08-19,0,BOS,0,6,7021,112,6,W
1918-08-20,0,BOS,8,4,6300,125,-4,NW
1918-08-21,0,BOS,1,4,3273,NA,3,W
1918-08-22,0,BOS,1,0,2651,NA,-1,NW
1918-08-23,0,BOS,5,6,2702,NA,1,W
1918-08-24,0,BOS,1,3,7019,NA,2,W
1918-08-26,0,BOS,6,3,3668,NA,-3,NW
1918-08-27,0,BOS,2,1,4861,NA,-1,NW
1918-08-28,0,BOS,0,3,4111,NA,3,W
1918-08-30,1,BOS,0,12,NA,91,12,W
1918-08-30,2,BOS,1,4,4644,NA,3,W
1918-08-31,1,BOS,1,6,0,90,5,W
1918-08-31,2,BOS,1,0,7974,80,-1,NW
1919-05-01,0,BOS,7,3,13000,155,-4,NW
1919-05-02,0,BOS,3,1,4000,127,-2,NW
1919-05-03,0,BOS,2,3,15700,118,1,W
1919-05-05,0,BOS,5,1,6000,115,-4,NW
1919-05-06,0,BOS,0,2,4000,103,2,W
1919-05-08,0,BOS,0,3,8000,119,3,W
1919-06-05,0,BOS,1,2,NA,110,1,W
1919-06-06,0,BOS,1,3,NA,119,2,W
1919-06-07,0,BOS,10,5,18000,130,-5,NW
1919-06-10,0,BOS,5,3,5000,105,-2,NW
1919-06-11,0,BOS,3,0,6000,115,-3,NW
1919-06-12,0,BOS,0,4,NA,95,4,W
1919-06-13,0,BOS,1,6,NA,105,5,W
1919-06-14,0,BOS,3,2,19000,150,-1,NW
1919-06-16,0,BOS,1,0,NA,97,-1,NW
1919-06-17,1,BOS,4,3,5000,118,-1,NW
1919-06-17,2,BOS,3,2,12000,122,-1,NW
1919-06-18,0,BOS,3,2,NA,118,-1,NW
1919-06-19,0,BOS,1,2,NA,130,1,W
1919-06-20,0,BOS,1,3,NA,113,2,W
1919-06-21,0,BOS,3,3,12000,115,0,NW
1919-06-23,0,BOS,12,3,3000,127,-9,NW
1919-06-24,0,BOS,2,5,NA,118,3,W
1919-06-25,1,BOS,8,3,NA,107,-5,NW
1919-06-25,2,BOS,0,1,NA,87,1,W
1919-06-26,0,BOS,3,1,NA,124,-2,NW
1919-07-04,1,BOS,2,9,4000,128,7,W
1919-07-04,2,BOS,6,9,10000,117,3,W
1919-07-05,1,BOS,5,3,0,130,-2,NW
1919-07-05,2,BOS,8,6,10000,130,-2,NW
1919-07-07,1,BOS,0,2,NA,95,2,W
1919-07-07,2,BOS,4,5,NA,135,1,W
1919-07-24,0,BOS,3,4,3500,135,1,W
1919-07-25,0,BOS,6,8,NA,135,2,W
1919-07-26,0,BOS,8,5,15000,160,-3,NW
1919-07-28,0,BOS,1,5,4000,120,4,W
1919-07-29,0,BOS,10,8,NA,128,-2,NW
1919-07-30,1,BOS,3,1,0,120,-2,NW
1919-07-30,2,BOS,2,3,21000,120,1,W
1919-07-31,0,BOS,1,2,NA,135,1,W
1919-08-02,1,BOS,3,5,0,118,2,W
1919-08-02,2,BOS,10,1,31500,125,-9,NW
1919-08-04,0,BOS,1,2,6000,118,1,W
1919-08-05,0,BOS,5,7,10000,115,2,W
1919-08-07,0,BOS,7,8,NA,125,1,W
1919-08-08,0,BOS,5,4,NA,125,-1,NW
1919-08-09,1,BOS,5,3,0,100,-2,NW
1919-08-09,2,BOS,3,4,24000,150,1,W
1919-08-11,0,BOS,0,1,NA,100,1,W
1919-08-12,0,BOS,10,3,NA,113,-7,NW
1919-08-27,0,BOS,6,4,3000,85,-2,NW
1919-08-28,1,BOS,8,3,0,100,-5,NW
1919-08-28,2,BOS,0,2,10000,90,2,W
1919-08-29,0,BOS,1,7,NA,105,6,W
1919-09-01,1,BOS,1,2,0,102,1,W
1919-09-01,2,BOS,1,4,29650,107,3,W
1919-09-11,1,BOS,0,4,0,95,4,W
1919-09-11,2,BOS,0,6,2200,80,6,W
1919-09-12,0,BOS,4,3,NA,110,-1,NW
1919-09-13,0,BOS,4,3,13000,110,-1,NW
1919-09-17,1,BOS,7,6,0,135,-1,NW
1919-09-17,2,BOS,1,2,15000,121,1,W
1919-09-18,0,BOS,8,2,5000,121,-6,NW
1919-09-19,0,BOS,3,2,5000,89,-1,NW
1919-09-20,1,BOS,3,4,0,95,1,W
1919-09-20,2,BOS,4,5,31000,112,1,W
1920-04-15,0,BOS,6,7,6912,142,1,W
1920-04-17,0,BOS,1,2,3530,182,1,W
1920-04-19,1,BOS,0,6,8000,100,6,W
1920-04-19,2,BOS,3,8,28000,150,5,W
1920-04-20,0,BOS,2,3,5800,143,1,W
1920-05-05,0,BOS,3,4,3100,140,1,W
1920-05-06,0,BOS,1,3,4200,90,2,W
1920-05-07,0,BOS,5,4,4000,105,-1,NW
1920-05-10,0,BOS,1,7,3750,97,6,W
1920-05-12,0,BOS,9,7,11264,140,-2,NW
1920-05-15,0,BOS,2,1,11200,110,-1,NW
1920-05-17,0,BOS,1,2,7500,91,1,W
1920-05-18,0,BOS,4,3,7500,115,-1,NW
1920-05-19,0,BOS,2,3,6500,111,1,W
1920-05-20,0,BOS,0,6,6500,100,6,W
1920-05-21,0,BOS,3,8,2400,128,5,W
1920-05-24,0,BOS,1,5,2500,95,4,W
1920-05-25,0,BOS,2,3,2500,110,1,W
1920-05-26,0,BOS,5,9,5500,123,4,W
1920-05-27,0,BOS,6,1,10000,136,-5,NW
1920-05-28,0,BOS,4,3,10000,135,-1,NW
1920-05-29,1,BOS,4,3,0,123,-1,NW
1920-05-29,2,BOS,8,3,25000,118,-5,NW
1920-05-31,1,BOS,1,3,0,100,2,W
1920-05-31,2,BOS,9,4,23000,118,-5,NW
1920-06-01,1,BOS,8,6,0,118,-2,NW
1920-06-01,2,BOS,7,2,4700,110,-5,NW
1920-06-30,1,BOS,3,4,0,150,1,W
1920-06-30,2,BOS,5,2,4500,120,-3,NW
1920-07-01,0,BOS,1,0,3700,106,-1,NW
1920-07-02,0,BOS,9,10,3500,163,1,W
1920-07-08,0,BOS,4,0,3000,105,-4,NW
1920-07-09,0,BOS,1,2,3000,89,1,W
1920-07-10,0,BOS,9,2,6000,100,-7,NW
1920-07-12,0,BOS,3,2,3000,118,-1,NW
1920-07-13,0,BOS,10,4,4000,115,-6,NW
1920-07-14,1,BOS,5,6,0,120,1,W
1920-07-14,2,BOS,0,4,8000,90,4,W
1920-07-16,0,BOS,6,5,3500,115,-1,NW
1920-07-17,1,BOS,5,2,0,138,-3,NW
1920-07-17,2,BOS,5,2,18000,110,-3,NW
1920-07-19,1,BOS,10,6,0,121,-4,NW
1920-07-19,2,BOS,4,5,6300,135,1,W
1920-07-20,0,BOS,9,8,5000,152,-1,NW
1920-07-21,0,BOS,1,2,5000,104,1,W
1920-07-22,0,BOS,2,1,4500,89,-1,NW
1920-07-23,0,BOS,8,7,4000,112,-1,NW
1920-07-24,0,BOS,7,4,7000,95,-3,NW
1920-08-16,0,BOS,4,6,3500,116,2,W
1920-08-17,1,BOS,3,4,0,113,1,W
1920-08-17,2,BOS,3,1,6200,120,-2,NW
1920-08-18,0,BOS,5,6,2500,115,1,W
1920-08-19,0,BOS,4,0,4500,92,-4,NW
1920-08-21,1,BOS,0,12,0,110,12,W
1920-08-21,2,BOS,0,4,17000,95,4,W
1920-08-23,1,BOS,2,1,0,110,-1,NW
1920-08-23,2,BOS,3,4,12000,140,1,W
1920-08-24,0,BOS,2,7,4500,106,5,W
1920-08-25,0,BOS,1,11,4500,100,10,W
1920-08-26,0,BOS,8,0,4000,105,-8,NW
1920-08-27,0,BOS,6,5,3500,116,-1,NW
1920-08-28,0,BOS,7,0,7500,86,-7,NW
1920-08-30,0,BOS,0,4,4000,90,4,W
1920-08-31,0,BOS,3,7,4500,95,4,W
1920-09-01,0,BOS,2,6,7000,109,4,W
1920-09-02,0,BOS,2,6,6000,86,4,W
1920-09-03,0,BOS,5,3,6000,124,-2,NW
1920-09-04,1,BOS,5,3,0,148,-2,NW
1920-09-04,2,BOS,5,6,32000,120,1,W
1920-09-23,0,BOS,2,9,2500,80,7,W
1920-09-24,0,BOS,10,9,2500,110,-1,NW
1920-09-25,0,BOS,2,4,4000,88,2,W
1920-09-27,1,BOS,1,2,0,90,1,W
1920-09-27,2,BOS,0,2,2500,120,2,W
1920-09-28,1,BOS,3,5,0,100,2,W
1920-09-28,2,BOS,7,6,2500,123,-1,NW
1921-04-21,0,BOS,0,1,7500,77,1,W
1921-04-25,0,BOS,2,3,4200,98,1,W
1921-04-26,0,BOS,2,1,2300,100,-1,NW
1921-04-28,0,BOS,2,6,3500,80,4,W
1921-05-02,0,BOS,1,2,11000,85,1,W
1921-05-03,0,BOS,2,0,15000,122,-2,NW
1921-06-02,0,BOS,8,4,5000,100,-4,NW
1921-06-03,0,BOS,6,7,3900,141,1,W
1921-06-04,0,BOS,0,6,13000,75,6,W
1921-06-06,0,BOS,6,7,5100,126,1,W
1921-06-07,0,BOS,6,7,4000,126,1,W
1921-06-08,0,BOS,2,1,4000,110,-1,NW
1921-06-09,0,BOS,9,3,4000,98,-6,NW
1921-06-10,0,BOS,3,7,3500,99,4,W
1921-06-11,0,BOS,2,4,12000,105,2,W
1921-06-13,0,BOS,6,4,2800,105,-2,NW
1921-06-14,0,BOS,8,6,2800,118,-2,NW
1921-06-16,0,BOS,3,8,4800,100,5,W
1921-06-17,1,BOS,4,5,0,145,1,W
1921-06-17,2,BOS,4,6,25000,115,2,W
1921-06-18,0,BOS,7,11,9000,135,4,W
1921-06-20,0,BOS,7,6,8000,110,-1,NW
1921-06-21,1,BOS,3,8,0,122,5,W
1921-06-21,2,BOS,1,6,18000,105,5,W
1921-06-22,1,BOS,8,2,0,110,-6,NW
1921-06-22,2,BOS,1,5,12000,116,4,W
1921-06-23,0,BOS,6,1,3500,135,-5,NW
1921-06-24,0,BOS,5,3,2500,95,-2,NW
1921-06-25,1,BOS,3,2,0,100,-1,NW
1921-06-25,2,BOS,4,3,12000,105,-1,NW
1921-06-27,0,BOS,5,6,2600,110,1,W
1921-06-28,0,BOS,1,8,1300,92,7,W
1921-07-04,1,BOS,4,1,0,105,-3,NW
1921-07-04,2,BOS,7,3,10000,110,-4,NW
1921-07-05,1,BOS,7,5,0,127,-2,NW
1921-07-05,2,BOS,4,1,5000,107,-3,NW
1921-07-06,1,BOS,1,2,0,133,1,W
1921-07-06,2,BOS,1,0,3500,95,-1,NW
1921-07-26,0,BOS,8,2,NA,120,-6,NW
1921-07-27,0,BOS,4,5,NA,122,1,W
1921-07-28,0,BOS,5,4,NA,115,-1,NW
1921-07-29,0,BOS,3,0,NA,100,-3,NW
1921-08-01,0,BOS,0,2,1500,83,2,W
1921-08-02,1,BOS,8,5,0,123,-3,NW
1921-08-02,2,BOS,5,2,1000,103,-3,NW
1921-08-03,0,BOS,2,3,2500,84,1,W
1921-08-04,0,BOS,5,4,NA,102,-1,NW
1921-08-05,0,BOS,1,10,NA,103,9,W
1921-08-06,0,BOS,4,9,NA,90,5,W
1921-08-08,0,BOS,1,6,NA,90,5,W
1921-08-09,1,BOS,7,8,NA,120,1,W
1921-08-09,2,BOS,1,4,NA,103,3,W
1921-08-10,0,BOS,8,4,NA,118,-4,NW
1921-09-01,0,BOS,4,2,2500,97,-2,NW
1921-09-02,0,BOS,3,4,2000,105,1,W
1921-09-03,0,BOS,10,11,2500,105,1,W
1921-09-05,1,BOS,8,0,0,112,-8,NW
1921-09-05,2,BOS,2,8,28400,96,6,W
1921-09-06,0,BOS,1,2,3000,92,1,W
1921-09-13,0,BOS,7,2,3000,105,-5,NW
1921-09-14,0,BOS,0,1,2000,94,1,W
1921-09-15,0,BOS,5,1,2000,91,-4,NW
1921-09-16,0,BOS,4,10,2000,99,6,W
1921-09-17,0,BOS,3,6,6000,111,3,W
1921-09-19,1,BOS,2,6,0,91,4,W
1921-09-19,2,BOS,5,8,2500,112,3,W
1921-09-20,0,BOS,4,7,5000,119,3,W
1921-09-21,0,BOS,5,1,1500,122,-4,NW
1921-09-22,0,BOS,9,8,4000,175,-1,NW
1921-09-23,1,BOS,10,2,0,105,-8,NW
1921-09-23,2,BOS,5,10,4000,100,5,W
1921-09-24,1,BOS,1,2,0,83,1,W
1921-09-24,2,BOS,11,0,4500,105,-11,NW
1921-09-29,0,BOS,2,5,1200,90,3,W
1921-09-30,0,BOS,6,4,1000,87,-2,NW
1921-10-01,1,BOS,7,2,0,125,-5,NW
1921-10-01,2,BOS,6,1,1600,109,-5,NW
1922-04-12,0,BOS,3,2,10000,105,-1,NW
1922-04-13,0,BOS,2,6,3400,107,4,W
1922-04-14,0,BOS,8,2,3500,90,-6,NW
1922-04-18,0,BOS,10,8,2500,115,-2,NW
1922-04-19,1,BOS,3,5,0,97,2,W
1922-04-19,2,BOS,6,1,18400,108,-5,NW
1922-05-03,0,BOS,0,8,4300,105,8,W
1922-05-06,0,BOS,0,1,10000,105,1,W
1922-05-08,0,BOS,6,2,3300,97,-4,NW
1922-05-09,0,BOS,6,2,3000,106,-4,NW
1922-05-10,0,BOS,10,9,4000,166,-1,NW
1922-05-11,0,BOS,5,3,3500,133,-2,NW
1922-05-12,0,BOS,0,5,3200,96,5,W
1922-05-13,0,BOS,1,3,5000,87,2,W
1922-05-15,0,BOS,0,2,3500,108,2,W
1922-05-16,0,BOS,6,5,3500,145,-1,NW
1922-05-17,0,BOS,3,4,3000,85,1,W
1922-05-20,0,BOS,5,2,12000,115,-3,NW
1922-05-22,0,BOS,7,1,3000,110,-6,NW
1922-05-23,0,BOS,5,3,3000,118,-2,NW
1922-05-24,0,BOS,2,6,3800,111,4,W
1922-05-26,0,BOS,6,7,3200,106,1,W
1922-05-27,1,BOS,3,2,0,129,-1,NW
1922-05-27,2,BOS,2,1,6500,106,-1,NW
1922-05-29,1,BOS,2,0,0,102,-2,NW
1922-05-29,2,BOS,8,9,6500,155,1,W
1922-05-30,1,BOS,7,4,0,129,-3,NW
1922-05-30,2,BOS,5,3,21000,132,-2,NW
1922-05-31,1,BOS,4,6,0,115,2,W
1922-05-31,2,BOS,7,4,3500,110,-3,NW
1922-06-22,0,BOS,2,6,5000,98,4,W
1922-06-23,0,BOS,4,5,2000,112,1,W
1922-06-24,1,BOS,7,12,0,132,5,W
1922-06-24,2,BOS,2,5,12000,105,3,W
1922-06-26,0,BOS,6,4,8500,123,-2,NW
1922-07-07,1,BOS,1,0,0,121,-1,NW
1922-07-07,2,BOS,4,5,10000,141,1,W
1922-07-08,1,BOS,1,2,0,98,1,W
1922-07-08,2,BOS,10,6,19000,118,-4,NW
1922-07-10,1,BOS,5,4,0,145,-1,NW
1922-07-10,2,BOS,3,4,9000,115,1,W
1922-07-11,0,BOS,2,0,7500,110,-2,NW
1922-07-12,0,BOS,11,7,3000,112,-4,NW
1922-07-13,0,BOS,4,2,2500,100,-2,NW
1922-07-14,0,BOS,5,3,2800,130,-2,NW
1922-07-15,0,BOS,2,0,NA,110,-2,NW
1922-07-17,0,BOS,16,7,3000,123,-9,NW
1922-07-18,0,BOS,5,6,2500,135,1,W
1922-07-19,0,BOS,8,0,2000,104,-8,NW
1922-07-20,0,BOS,2,3,2500,125,1,W
1922-07-21,0,BOS,7,8,NA,154,1,W
1922-07-22,0,BOS,5,2,7800,105,-3,NW
1922-08-11,0,BOS,5,4,1500,116,-1,NW
1922-08-15,0,BOS,19,11,2500,147,-8,NW
1922-08-16,0,BOS,3,5,2500,107,2,W
1922-08-17,1,BOS,2,3,0,130,1,W
1922-08-17,2,BOS,1,5,3500,102,4,W
1922-08-18,0,BOS,0,8,2500,98,8,W
1922-08-19,1,BOS,5,1,0,110,-4,NW
1922-08-19,2,BOS,1,0,7000,88,-1,NW
1922-08-21,0,BOS,16,3,NA,118,-13,NW
1922-08-22,0,BOS,9,4,3000,122,-5,NW
1922-08-23,0,BOS,6,3,3000,96,-3,NW
1922-08-24,0,BOS,13,2,2500,97,-11,NW
1922-08-25,0,BOS,0,9,2000,94,9,W
1922-09-07,1,BOS,7,4,0,96,-3,NW
1922-09-07,2,BOS,3,0,2800,72,-3,NW
1922-09-08,0,BOS,1,2,NA,90,1,W
1922-09-09,1,BOS,3,1,0,90,-2,NW
1922-09-09,2,BOS,2,3,4000,76,1,W
1922-09-28,0,BOS,1,3,4000,108,2,W
1922-09-29,0,BOS,0,1,4500,114,1,W
1922-09-30,0,BOS,3,1,15000,116,-2,NW
1923-04-26,0,BOS,4,5,20000,120,1,W
1923-04-27,0,BOS,4,2,6000,116,-2,NW
1923-04-28,0,BOS,3,5,7500,114,2,W
1923-04-30,0,BOS,4,2,4500,120,-2,NW
1923-05-01,0,BOS,4,5,3100,100,1,W
1923-05-02,0,BOS,4,3,4000,91,-1,NW
1923-05-03,0,BOS,1,3,4000,80,2,W
1923-05-24,0,BOS,7,1,3100,105,-6,NW
1923-05-25,0,BOS,5,6,NA,112,1,W
1923-05-26,0,BOS,3,2,9000,117,-1,NW
1923-06-04,0,BOS,6,5,4000,146,-1,NW
1923-06-05,0,BOS,6,10,3500,127,4,W
1923-06-06,0,BOS,17,4,2000,120,-13,NW
1923-06-07,0,BOS,1,7,2500,105,6,W
1923-06-11,0,BOS,5,4,3000,90,-1,NW
1923-06-12,0,BOS,4,10,2700,94,6,W
1923-06-13,0,BOS,9,10,2500,158,1,W
1923-06-14,0,BOS,4,1,3800,90,-3,NW
1923-06-15,0,BOS,2,0,3500,110,-2,NW
1923-06-16,0,BOS,1,9,15000,109,8,W
1923-06-18,1,BOS,6,2,0,107,-4,NW
1923-06-18,2,BOS,9,0,15000,85,-9,NW
1923-06-19,0,BOS,12,6,2000,142,-6,NW
1923-06-20,0,BOS,1,3,2000,90,2,W
1923-06-21,0,BOS,3,1,1200,90,-2,NW
1923-06-22,0,BOS,4,2,5000,125,-2,NW
1923-06-23,0,BOS,4,0,7500,120,-4,NW
1923-06-25,0,BOS,14,6,1500,129,-8,NW
1923-06-26,0,BOS,1,3,12000,105,2,W
1923-07-02,0,BOS,4,7,2500,105,3,W
1923-07-04,1,BOS,3,1,0,97,-2,NW
1923-07-04,2,BOS,1,8,18000,113,7,W
1923-07-05,0,BOS,5,7,3000,114,2,W
1923-07-24,0,BOS,1,6,2400,90,5,W
1923-07-26,1,BOS,6,7,0,122,1,W
1923-07-26,2,BOS,15,3,4000,105,-12,NW
1923-07-27,0,BOS,10,7,NA,112,-3,NW
1923-07-28,0,BOS,5,10,7500,118,5,W
1923-07-30,1,BOS,5,4,0,95,-1,NW
1923-07-30,2,BOS,2,0,10000,85,-2,NW
1923-07-31,0,BOS,5,4,NA,148,-1,NW
1923-08-01,1,BOS,4,2,NA,118,-2,NW
1923-08-01,2,BOS,3,7,NA,105,4,W
1923-08-02,0,BOS,9,5,NA,122,-4,NW
1923-08-04,0,BOS,1,8,5000,99,7,W
1923-08-06,0,BOS,1,2,NA,95,1,W
1923-08-08,1,BOS,4,0,0,90,-4,NW
1923-08-08,2,BOS,2,3,6000,118,1,W
1923-08-09,0,BOS,3,4,2500,112,1,W
1923-08-11,0,BOS,3,4,8000,103,1,W
1923-08-30,0,BOS,1,8,2500,105,7,W
1923-08-31,0,BOS,3,1,NA,111,-2,NW
1923-09-01,0,BOS,1,6,5000,88,5,W
1923-09-03,1,BOS,4,5,0,102,1,W
1923-09-03,2,BOS,7,3,15000,122,-4,NW
1923-09-04,0,BOS,3,1,NA,97,-2,NW
1923-09-05,0,BOS,8,4,3000,99,-4,NW
1923-09-13,0,BOS,8,9,NA,124,1,W
1923-09-14,0,BOS,3,4,2500,127,1,W
1923-09-15,0,BOS,6,11,5000,137,5,W
1923-09-17,1,BOS,6,1,0,101,-5,NW
1923-09-17,2,BOS,5,6,3000,110,1,W
1923-09-18,0,BOS,6,2,NA,102,-4,NW
1923-09-19,0,BOS,1,2,NA,96,1,W
1923-09-20,1,BOS,5,4,0,132,-1,NW
1923-09-20,2,BOS,2,2,4000,112,0,NW
1923-09-21,1,BOS,3,4,NA,99,1,W
1923-09-21,2,BOS,15,6,NA,108,-9,NW
1923-09-22,1,BOS,10,0,0,98,-10,NW
1923-09-22,2,BOS,7,9,3500,135,2,W
1923-09-24,1,BOS,6,1,0,103,-5,NW
1923-09-24,2,BOS,4,2,1200,115,-2,NW
1923-09-25,0,BOS,8,2,1200,94,-6,NW
1923-09-26,0,BOS,2,3,NA,102,1,W
1923-09-27,0,BOS,8,3,3000,97,-5,NW
1923-09-28,0,BOS,24,4,3000,174,-20,NW
1923-09-29,1,BOS,4,5,0,63,1,W
1923-09-29,2,BOS,2,3,15000,212,1,W
1924-04-15,0,BOS,2,1,22000,120,-1,NW
1924-04-16,0,BOS,6,9,5500,120,3,W
1924-04-17,0,BOS,1,9,3000,125,8,W
1924-04-19,0,BOS,0,12,26000,102,12,W
1924-04-21,0,BOS,4,0,5500,92,-4,NW
1924-05-05,0,BOS,3,8,NA,138,5,W
1924-05-06,0,BOS,4,14,NA,130,10,W
1924-05-07,0,BOS,5,4,NA,131,-1,NW
1924-05-08,0,BOS,2,4,4000,113,2,W
1924-05-13,0,BOS,5,3,4000,113,-2,NW
1924-05-14,0,BOS,0,12,NA,120,12,W
1924-05-15,0,BOS,4,2,6000,108,-2,NW
1924-05-16,0,BOS,3,4,NA,154,1,W
1924-05-17,0,BOS,4,5,21000,128,1,W
1924-05-19,0,BOS,1,9,5000,137,8,W
1924-05-21,0,BOS,4,5,5000,110,1,W
1924-05-22,0,BOS,6,5,6000,134,-1,NW
1924-05-23,0,BOS,1,5,8000,106,4,W
1924-05-24,0,BOS,2,6,18000,114,4,W
1924-05-26,0,BOS,9,10,6000,160,1,W
1924-05-30,1,BOS,4,9,0,130,5,W
1924-05-30,2,BOS,10,5,35000,164,-5,NW
1924-05-31,0,BOS,12,0,15000,123,-12,NW
1924-06-23,1,BOS,2,0,0,122,-2,NW
1924-06-23,2,BOS,6,3,6500,103,-3,NW
1924-06-24,0,BOS,1,4,NA,104,3,W
1924-06-25,0,BOS,3,4,6000,90,1,W
1924-06-26,0,BOS,5,8,5000,125,3,W
1924-06-27,1,BOS,12,7,0,145,-5,NW
1924-06-27,2,BOS,10,5,16000,109,-5,NW
1924-06-28,0,BOS,4,3,22000,169,-1,NW
1924-07-08,0,BOS,8,7,2500,123,-1,NW
1924-07-09,1,BOS,4,5,0,134,1,W
1924-07-09,2,BOS,0,5,8000,102,5,W
1924-07-10,0,BOS,2,8,NA,113,6,W
1924-07-11,1,BOS,8,1,0,106,-7,NW
1924-07-11,2,BOS,6,7,10000,125,1,W
1924-07-12,0,BOS,17,8,NA,135,-9,NW
1924-07-14,0,BOS,6,2,NA,140,-4,NW
1924-07-15,0,BOS,8,6,NA,135,-2,NW
1924-07-16,1,BOS,5,4,0,120,-1,NW
1924-07-16,2,BOS,11,3,8000,130,-8,NW
1924-07-18,0,BOS,4,3,NA,148,-1,NW
1924-07-19,1,BOS,18,1,0,128,-17,NW
1924-07-19,2,BOS,4,3,17500,140,-1,NW
1924-07-21,0,BOS,2,1,NA,102,-1,NW
1924-07-22,0,BOS,3,4,NA,122,1,W
1924-07-23,0,BOS,12,16,NA,154,4,W
1924-07-24,0,BOS,9,10,NA,163,1,W
1924-08-13,1,BOS,0,6,0,118,6,W
1924-08-13,2,BOS,1,4,6000,100,3,W
1924-08-14,0,BOS,3,4,NA,92,1,W
1924-08-15,0,BOS,6,7,NA,110,1,W
1924-08-16,1,BOS,10,2,0,130,-8,NW
1924-08-16,2,BOS,6,4,15000,110,-2,NW
1924-08-18,0,BOS,2,3,2000,88,1,W
1924-08-19,0,BOS,5,11,2000,105,6,W
1924-08-20,0,BOS,4,5,NA,102,1,W
1924-08-21,0,BOS,1,2,NA,112,1,W
1924-08-22,0,BOS,4,5,3500,117,1,W
1924-08-23,0,BOS,8,6,6000,120,-2,NW
1924-08-25,0,BOS,3,4,6000,145,1,W
1924-08-27,1,BOS,5,4,0,116,-1,NW
1924-08-27,2,BOS,3,6,15000,98,3,W
1924-08-28,1,BOS,3,6,NA,106,3,W
1924-08-28,2,BOS,7,8,NA,123,1,W
1924-08-29,0,BOS,1,5,2500,98,4,W
1924-08-30,1,BOS,18,7,0,143,-11,NW
1924-08-30,2,BOS,7,2,12000,97,-5,NW
1924-09-08,0,BOS,2,0,5000,92,-2,NW
1924-09-09,0,BOS,5,4,5000,118,-1,NW
1924-09-11,1,BOS,4,3,0,127,-1,NW
1924-09-11,2,BOS,8,3,5000,113,-5,NW
1924-09-26,0,BOS,1,2,12000,108,1,W
1924-09-27,0,BOS,7,5,22000,130,-2,NW
1924-09-29,0,BOS,4,2,15000,112,-2,NW
1924-09-30,0,BOS,1,13,5000,75,12,W
1925-04-22,0,BOS,6,5,11000,141,-1,NW
1925-04-23,0,BOS,15,4,6500,126,-11,NW
1925-04-24,0,BOS,7,6,3000,115,-1,NW
1925-04-25,0,BOS,2,3,9000,121,1,W
1925-04-27,0,BOS,2,1,6000,94,-1,NW
1925-04-28,0,BOS,9,2,5000,91,-7,NW
1925-05-01,0,BOS,5,7,2500,122,2,W
1925-05-02,0,BOS,4,5,3000,124,1,W
1925-06-01,0,BOS,3,5,4000,105,2,W
1925-06-02,0,BOS,15,2,2500,107,-13,NW
1925-06-03,0,BOS,2,4,5000,105,2,W
1925-06-04,0,BOS,12,2,3000,118,-10,NW
1925-06-05,0,BOS,4,5,2000,125,1,W
1925-06-06,0,BOS,8,4,NA,133,-4,NW
1925-06-08,0,BOS,1,3,3000,110,2,W
1925-06-09,0,BOS,3,2,3500,103,-1,NW
1925-06-10,0,BOS,15,8,3500,132,-7,NW
1925-06-11,0,BOS,9,7,4000,127,-2,NW
1925-06-12,0,BOS,2,5,4000,112,3,W
1925-06-13,0,BOS,7,4,2000,113,-3,NW
1925-06-15,0,BOS,5,13,3000,135,8,W
1925-06-16,0,BOS,1,2,2500,93,1,W
1925-06-17,1,BOS,5,3,0,105,-2,NW
1925-06-17,2,BOS,6,7,18000,132,1,W
1925-06-18,0,BOS,5,1,2000,109,-4,NW
1925-06-19,0,BOS,6,3,4000,135,-3,NW
1925-06-20,0,BOS,11,9,20000,141,-2,NW
1925-06-22,0,BOS,8,4,3500,110,-4,NW
1925-06-27,1,BOS,10,5,0,125,-5,NW
1925-06-27,2,BOS,5,1,7000,105,-4,NW
1925-06-29,0,BOS,5,10,3000,126,5,W
1925-06-30,0,BOS,3,0,3000,97,-3,NW
1925-07-01,0,BOS,11,8,3500,128,-3,NW
1925-07-02,1,BOS,6,4,0,132,-2,NW
1925-07-02,2,BOS,11,4,6000,115,-7,NW
1925-07-03,0,BOS,11,0,2500,96,-11,NW
1925-07-04,1,BOS,4,7,NA,135,3,W
1925-07-04,2,BOS,5,1,18000,98,-4,NW
1925-07-28,0,BOS,16,7,NA,122,-9,NW
1925-07-29,0,BOS,10,5,3000,110,-5,NW
1925-07-30,0,BOS,7,2,2000,115,-5,NW
1925-07-31,0,BOS,2,7,2500,105,5,W
1925-08-01,0,BOS,5,2,NA,92,-3,NW
1925-08-03,0,BOS,12,4,3000,113,-8,NW
1925-08-04,0,BOS,10,7,1500,105,-3,NW
1925-08-06,0,BOS,10,0,1500,101,-10,NW
1925-08-07,0,BOS,2,0,2500,105,-2,NW
1925-08-08,1,BOS,3,4,NA,154,1,W
1925-08-08,2,BOS,0,3,NA,97,3,W
1925-08-10,0,BOS,8,7,3000,134,-1,NW
1925-08-11,0,BOS,0,1,3000,101,1,W
1925-08-12,0,BOS,2,7,3000,110,5,W
1925-08-14,0,BOS,6,3,1500,116,-3,NW
1925-08-15,1,BOS,3,1,0,100,-2,NW
1925-08-15,2,BOS,0,5,20000,85,5,W
1925-09-07,0,BOS,1,5,4500,88,4,W
1925-09-08,1,BOS,5,4,0,124,-1,NW
1925-09-08,2,BOS,7,4,5000,106,-3,NW
1925-09-09,0,BOS,4,5,3000,100,1,W
1925-09-15,0,BOS,2,1,3000,101,-1,NW
1925-09-17,1,BOS,0,2,0,76,2,W
1925-09-17,2,BOS,0,4,1000,97,4,W
1925-09-18,0,BOS,6,5,NA,92,-1,NW
1925-09-19,1,BOS,2,3,NA,125,1,W
1925-09-19,2,BOS,5,0,NA,101,-5,NW
1925-09-22,1,BOS,11,8,0,130,-3,NW
1925-09-22,2,BOS,7,2,3500,123,-5,NW
1925-09-23,0,BOS,15,1,NA,115,-14,NW
1925-09-24,0,BOS,0,5,NA,87,5,W
1925-09-25,0,BOS,10,5,NA,92,-5,NW
1925-09-26,1,BOS,8,5,NA,105,-3,NW
1925-09-26,2,BOS,6,0,NA,91,-6,NW
1925-09-30,0,BOS,4,5,NA,89,1,W
1925-10-01,0,BOS,1,3,NA,82,2,W
1925-10-02,0,BOS,2,11,NA,88,9,W
1926-04-13,0,BOS,12,11,11000,180,-1,NW
1926-04-14,0,BOS,7,8,3500,123,1,W
1926-04-16,0,BOS,3,2,1500,107,-1,NW
1926-04-17,0,BOS,1,6,14000,92,5,W
1926-04-19,1,BOS,3,1,0,112,-2,NW
1926-04-19,2,BOS,1,2,15000,100,1,W
1926-05-03,0,BOS,6,2,NA,110,-4,NW
1926-05-04,0,BOS,8,7,3000,118,-1,NW
1926-05-05,0,BOS,11,0,3000,105,-11,NW
1926-05-06,0,BOS,0,1,3000,98,1,W
1926-05-07,0,BOS,11,2,NA,116,-9,NW
1926-05-08,0,BOS,10,4,9000,120,-6,NW
1926-05-10,0,BOS,3,0,NA,119,-3,NW
1926-05-12,0,BOS,2,4,3000,116,2,W
1926-05-13,0,BOS,13,10,4500,146,-3,NW
1926-05-14,0,BOS,8,1,NA,121,-7,NW
1926-05-18,0,BOS,3,6,3000,105,3,W
1926-05-19,0,BOS,9,7,3500,118,-2,NW
1926-05-20,0,BOS,13,4,2500,100,-9,NW
1926-05-21,0,BOS,7,8,NA,110,1,W
1926-05-22,0,BOS,8,14,NA,154,6,W
1926-05-24,0,BOS,4,2,4500,85,-2,NW
1926-05-25,1,BOS,5,3,0,105,-2,NW
1926-05-25,2,BOS,5,4,16561,105,-1,NW
1926-05-26,0,BOS,9,8,4000,120,-1,NW
1926-05-31,1,BOS,0,2,0,90,2,W
1926-05-31,2,BOS,8,2,18800,97,-6,NW
1926-06-02,1,BOS,4,5,0,118,1,W
1926-06-02,2,BOS,5,1,7000,99,-4,NW
1926-06-24,0,BOS,5,6,4500,140,1,W
1926-06-25,1,BOS,12,2,0,130,-10,NW
1926-06-25,2,BOS,11,4,15000,125,-7,NW
1926-06-28,0,BOS,2,6,NA,115,4,W
1926-06-29,0,BOS,1,2,3500,101,1,W
1926-06-30,0,BOS,8,5,4000,133,-3,NW
1926-07-08,0,BOS,3,7,3000,120,4,W
1926-07-09,0,BOS,9,0,3000,106,-9,NW
1926-07-10,1,BOS,5,6,0,139,1,W
1926-07-10,2,BOS,4,2,NA,133,-2,NW
1926-07-12,0,BOS,5,2,5000,130,-3,NW
1926-07-13,0,BOS,6,1,2500,104,-5,NW
1926-07-15,1,BOS,4,2,0,92,-2,NW
1926-07-15,2,BOS,2,6,3500,115,4,W
1926-07-17,1,BOS,2,3,0,100,1,W
1926-07-17,2,BOS,3,4,15000,115,1,W
1926-07-19,0,BOS,5,4,3000,125,-1,NW
1926-07-20,0,BOS,13,2,3000,117,-11,NW
1926-07-21,1,BOS,11,1,0,110,-10,NW
1926-07-21,2,BOS,7,4,3700,114,-3,NW
1926-07-22,0,BOS,5,4,1000,148,-1,NW
1926-07-23,0,BOS,6,4,3000,120,-2,NW
1926-07-24,1,BOS,9,14,0,132,5,W
1926-07-24,2,BOS,5,5,12000,100,0,NW
1926-08-12,1,BOS,5,1,0,101,-4,NW
1926-08-12,2,BOS,5,0,5500,70,-5,NW
1926-08-14,1,BOS,1,3,0,113,2,W
1926-08-14,2,BOS,3,2,7500,115,-1,NW
1926-08-16,1,BOS,6,1,NA,91,-5,NW
1926-08-16,2,BOS,1,7,NA,81,6,W
1926-08-17,1,BOS,1,5,0,114,4,W
1926-08-17,2,BOS,0,4,4500,95,4,W
1926-08-18,0,BOS,2,4,2500,94,2,W
1926-08-19,0,BOS,0,1,2500,89,1,W
1926-08-20,0,BOS,5,1,3000,91,-4,NW
1926-08-21,0,BOS,6,0,10000,105,-6,NW
1926-08-23,0,BOS,9,1,NA,114,-8,NW
1926-08-25,1,BOS,11,4,NA,120,-7,NW
1926-08-25,2,BOS,7,6,5000,126,-1,NW
1926-08-27,1,BOS,9,3,0,107,-6,NW
1926-08-27,2,BOS,5,4,3000,135,-1,NW
1926-08-28,1,BOS,6,1,0,89,-5,NW
1926-08-28,2,BOS,5,1,5000,100,-4,NW
1926-08-31,0,BOS,2,0,2500,78,-2,NW
1926-09-01,0,BOS,14,12,2500,154,-2,NW
1926-09-03,1,BOS,3,2,0,129,-1,NW
1926-09-03,2,BOS,5,1,3600,122,-4,NW
1926-09-04,0,BOS,5,1,8000,101,-4,NW
1927-04-21,0,BOS,7,4,10000,120,-3,NW
1927-04-22,0,BOS,7,3,2500,115,-4,NW
1927-04-23,0,BOS,4,5,5000,136,1,W
1927-04-26,0,BOS,9,8,3500,134,-1,NW
1927-04-27,0,BOS,4,1,3000,115,-3,NW
1927-04-29,0,BOS,9,0,NA,100,-9,NW
1927-04-30,0,BOS,2,3,15000,120,1,W
1927-05-26,1,BOS,3,1,0,103,-2,NW
1927-05-26,2,BOS,3,4,6000,130,1,W
1927-05-28,1,BOS,8,6,NA,123,-2,NW
1927-05-28,2,BOS,4,3,NA,115,-1,NW
1927-06-02,0,BOS,7,2,3500,116,-5,NW
1927-06-03,0,BOS,5,1,4000,122,-4,NW
1927-06-04,0,BOS,6,4,NA,141,-2,NW
1927-06-06,0,BOS,10,2,3000,115,-8,NW
1927-06-07,0,BOS,5,6,2500,120,1,W
1927-06-08,0,BOS,5,3,3500,113,-2,NW
1927-06-09,0,BOS,6,4,2500,127,-2,NW
1927-06-10,0,BOS,10,5,NA,180,-5,NW
1927-06-11,0,BOS,10,5,10000,130,-5,NW
1927-06-13,0,BOS,2,0,2000,95,-2,NW
1927-06-16,0,BOS,10,11,NA,137,1,W
1927-06-17,1,BOS,6,3,0,127,-3,NW
1927-06-17,2,BOS,4,3,12000,120,-1,NW
1927-06-18,0,BOS,0,5,NA,105,5,W
1927-06-21,1,BOS,7,3,0,106,-4,NW
1927-06-21,2,BOS,7,1,15000,104,-6,NW
1927-06-22,1,BOS,7,4,0,136,-3,NW
1927-06-22,2,BOS,3,2,14000,127,-1,NW
1927-06-23,0,BOS,11,4,2000,118,-7,NW
1927-06-24,0,BOS,5,3,NA,113,-2,NW
1927-06-25,0,BOS,8,3,NA,123,-5,NW
1927-06-27,0,BOS,9,8,NA,145,-1,NW
1927-06-28,0,BOS,4,0,2500,111,-4,NW
1927-07-04,1,BOS,10,2,0,120,-8,NW
1927-07-04,2,BOS,3,11,15000,119,8,W
1927-07-05,0,BOS,5,6,2000,118,1,W
1927-07-06,1,BOS,5,1,0,92,-4,NW
1927-07-06,2,BOS,7,6,6000,120,-1,NW
1927-07-25,0,BOS,7,10,NA,122,3,W
1927-07-26,0,BOS,7,2,2500,110,-5,NW
1927-07-28,1,BOS,0,3,0,102,3,W
1927-07-28,2,BOS,3,4,4000,119,1,W
1927-07-29,0,BOS,2,8,NA,100,6,W
1927-07-30,1,BOS,4,5,NA,113,1,W
1927-07-30,2,BOS,9,2,NA,108,-7,NW
1927-08-02,1,BOS,3,2,0,92,-1,NW
1927-08-02,2,BOS,0,3,5000,75,3,W
1927-08-03,0,BOS,1,2,4000,105,1,W
1927-08-04,0,BOS,1,2,3000,116,1,W
1927-08-05,0,BOS,1,4,NA,115,3,W
1927-08-06,0,BOS,2,4,NA,115,2,W
1927-08-08,0,BOS,2,3,4500,109,1,W
1927-09-05,1,BOS,11,12,0,260,1,W
1927-09-05,2,BOS,5,0,36000,55,-5,NW
1927-09-06,1,BOS,14,2,0,118,-12,NW
1927-09-06,2,BOS,2,5,20000,86,3,W
1927-09-07,0,BOS,12,10,13000,151,-2,NW
1927-09-08,0,BOS,8,10,2000,140,2,W
1927-09-09,0,BOS,1,6,NA,104,5,W
1927-09-10,0,BOS,3,1,NA,101,-2,NW
1927-09-13,1,BOS,4,5,0,134,1,W
1927-09-13,2,BOS,2,3,3000,95,1,W
1927-09-14,0,BOS,6,9,2000,123,3,W
1927-09-15,0,BOS,2,1,1500,86,-1,NW
1927-09-16,0,BOS,4,3,NA,110,-1,NW
1927-09-17,1,BOS,8,4,0,110,-4,NW
1927-09-17,2,BOS,11,5,10000,110,-6,NW
1927-09-20,1,BOS,4,3,NA,118,-1,NW
1927-09-20,2,BOS,5,3,3000,119,-2,NW
1927-09-21,0,BOS,2,3,NA,120,1,W
1927-09-22,0,BOS,1,2,NA,123,1,W
1927-09-23,0,BOS,2,1,NA,115,-1,NW
1927-09-24,0,BOS,0,3,3000,87,3,W
1927-09-26,1,BOS,4,2,NA,102,-2,NW
1927-09-26,2,BOS,11,1,NA,100,-10,NW
1927-09-28,1,BOS,2,1,0,108,-1,NW
1927-09-28,2,BOS,6,4,2500,115,-2,NW
1928-04-11,0,BOS,8,4,8000,115,-4,NW
1928-04-13,0,BOS,6,4,4500,115,-2,NW
1928-04-14,0,BOS,0,0,2500,50,0,NW
1928-04-16,0,BOS,7,2,3000,122,-5,NW
1928-04-18,0,BOS,10,7,3000,130,-3,NW
1928-04-19,1,BOS,6,7,4000,115,1,W
1928-04-19,2,BOS,7,2,35000,95,-5,NW
1928-04-30,0,BOS,4,1,NA,94,-3,NW
1928-05-01,0,BOS,5,3,3700,123,-2,NW
1928-05-03,0,BOS,1,3,5200,97,2,W
1928-05-04,0,BOS,2,3,3000,108,1,W
1928-05-05,0,BOS,5,4,10000,115,-1,NW
1928-05-07,0,BOS,4,2,NA,115,-2,NW
1928-05-08,0,BOS,1,5,3000,102,4,W
1928-05-10,0,BOS,9,2,3000,112,-7,NW
1928-05-11,0,BOS,3,4,NA,96,1,W
1928-05-12,0,BOS,2,15,NA,109,13,W
1928-05-14,0,BOS,2,3,2000,104,1,W
1928-05-15,0,BOS,1,3,4000,97,2,W
1928-05-16,0,BOS,4,5,6000,182,1,W
1928-05-17,0,BOS,3,5,7500,112,2,W
1928-05-25,0,BOS,0,5,4500,81,5,W
1928-05-28,0,BOS,2,0,10770,101,-2,NW
1928-05-29,0,BOS,4,3,NA,114,-1,NW
1928-05-30,1,BOS,8,1,0,100,-7,NW
1928-05-30,2,BOS,9,2,36000,117,-7,NW
1928-06-27,1,BOS,1,4,NA,116,3,W
1928-06-27,2,BOS,4,11,8600,121,7,W
1928-06-28,1,BOS,4,3,NA,111,-1,NW
1928-06-28,2,BOS,7,8,7500,132,1,W
1928-06-30,1,BOS,11,4,0,116,-7,NW
1928-06-30,2,BOS,7,6,35000,120,-1,NW
1928-07-07,1,BOS,20,8,NA,144,-12,NW
1928-07-07,2,BOS,4,3,15000,177,-1,NW
1928-07-09,1,BOS,0,4,0,108,4,W
1928-07-09,2,BOS,2,8,4600,110,6,W
1928-07-10,0,BOS,4,2,2500,114,-2,NW
1928-07-11,0,BOS,3,4,3000,105,1,W
1928-07-12,0,BOS,3,1,3500,108,-2,NW
1928-07-14,1,BOS,11,4,0,102,-7,NW
1928-07-14,2,BOS,11,2,8000,112,-9,NW
1928-07-16,1,BOS,4,0,0,119,-4,NW
1928-07-16,2,BOS,9,1,5500,126,-8,NW
1928-07-17,0,BOS,6,9,2000,122,3,W
1928-07-18,0,BOS,6,5,2000,135,-1,NW
1928-07-19,0,BOS,2,3,2500,122,1,W
1928-07-21,1,BOS,2,5,0,93,3,W
1928-07-21,2,BOS,5,1,12000,117,-4,NW
1928-07-23,0,BOS,3,8,10000,113,5,W
1928-07-24,0,BOS,5,3,12000,137,-2,NW
1928-08-09,0,BOS,7,1,11000,114,-6,NW
1928-08-10,0,BOS,5,2,7600,123,-3,NW
1928-08-11,0,BOS,5,2,10000,126,-3,NW
1928-08-13,0,BOS,2,6,2500,100,4,W
1928-08-14,0,BOS,2,1,2500,91,-1,NW
1928-08-15,0,BOS,7,0,2000,104,-7,NW
1928-08-16,0,BOS,10,8,2000,123,-2,NW
1928-08-17,0,BOS,3,4,2000,126,1,W
1928-08-18,0,BOS,1,3,5000,115,2,W
1928-08-20,0,BOS,6,4,3300,130,-2,NW
1928-08-21,0,BOS,4,3,2500,115,-1,NW
1928-08-22,1,BOS,7,6,0,145,-1,NW
1928-08-22,2,BOS,4,3,500,131,-1,NW
1928-08-23,0,BOS,2,1,2000,104,-1,NW
1928-08-24,0,BOS,1,2,2000,100,1,W
1928-08-25,0,BOS,4,7,8000,120,3,W
1928-08-27,1,BOS,8,6,0,123,-2,NW
1928-08-27,2,BOS,4,0,4200,92,-4,NW
1928-08-28,0,BOS,8,6,3000,126,-2,NW
1928-08-29,0,BOS,4,3,2500,120,-1,NW
1928-09-07,1,BOS,1,0,0,104,-1,NW
1928-09-07,2,BOS,7,3,12000,100,-4,NW
1928-09-08,1,BOS,7,6,0,141,-1,NW
1928-09-08,2,BOS,7,4,28000,107,-3,NW
1929-04-23,0,BOS,2,4,17000,115,2,W
1929-04-24,0,BOS,9,3,9000,133,-6,NW
1929-04-26,0,BOS,1,2,600,95,1,W
1929-04-27,0,BOS,3,2,15000,114,-1,NW
1929-04-28,0,BOS,7,3,23000,100,-4,NW
1929-04-30,0,BOS,1,4,3500,91,3,W
1929-05-01,0,BOS,24,6,3000,149,-18,NW
1929-05-02,0,BOS,5,1,5000,103,-4,NW
1929-05-23,0,BOS,7,6,4700,137,-1,NW
1929-05-24,0,BOS,0,5,3000,109,5,W
1929-05-25,1,BOS,8,10,0,125,2,W
1929-05-25,2,BOS,8,3,28000,122,-5,NW
1929-05-26,0,BOS,15,4,25000,155,-11,NW
1929-05-28,0,BOS,4,5,3500,115,1,W
1929-05-29,0,BOS,7,1,3000,110,-6,NW
1929-05-30,1,BOS,9,2,0,106,-7,NW
1929-05-30,2,BOS,9,3,17000,100,-6,NW
1929-06-01,0,BOS,3,2,8000,108,-1,NW
1929-06-02,0,BOS,3,12,6000,110,9,W
1929-06-04,0,BOS,4,0,2000,109,-4,NW
1929-06-05,0,BOS,2,17,2500,112,15,W
1929-06-06,0,BOS,9,5,4000,119,-4,NW
1929-06-08,1,BOS,7,2,9000,107,-5,NW
1929-06-08,2,BOS,1,4,9000,110,3,W
1929-06-09,0,BOS,6,7,10000,133,1,W
1929-06-10,0,BOS,1,0,5000,107,-1,NW
1929-06-11,0,BOS,5,3,3500,118,-2,NW
1929-06-13,0,BOS,1,4,3000,93,3,W
1929-06-14,0,BOS,7,6,3200,128,-1,NW
1929-06-15,0,BOS,12,8,4000,198,-4,NW
1929-06-16,0,BOS,5,2,7000,119,-3,NW
1929-06-17,1,BOS,5,6,0,128,1,W
1929-06-17,2,BOS,8,3,12000,120,-5,NW
1929-06-27,0,BOS,1,4,2500,123,3,W
1929-06-28,0,BOS,2,5,3000,106,3,W
1929-06-29,0,BOS,2,5,8000,118,3,W
1929-06-30,0,BOS,6,4,23000,142,-2,NW
1929-07-23,0,BOS,11,4,2500,113,-7,NW
1929-07-24,0,BOS,7,9,1500,117,2,W
1929-07-26,0,BOS,4,1,3000,118,-3,NW
1929-07-27,0,BOS,0,4,5000,109,4,W
1929-07-28,0,BOS,5,3,6500,119,-2,NW
1929-07-30,0,BOS,11,4,2000,118,-7,NW
1929-07-31,1,BOS,0,4,0,93,4,W
1929-07-31,2,BOS,6,2,5500,97,-4,NW
1929-08-01,0,BOS,10,3,2000,105,-7,NW
1929-08-02,0,BOS,2,3,2000,118,1,W
1929-08-03,0,BOS,15,4,7500,108,-11,NW
1929-08-04,0,BOS,0,8,5000,112,8,W
1929-08-07,0,BOS,4,2,4000,116,-2,NW
1929-08-08,0,BOS,3,2,3000,113,-1,NW
1929-09-01,0,BOS,6,4,22000,115,-2,NW
1929-09-02,1,BOS,10,7,20000,128,-3,NW
1929-09-02,2,BOS,2,7,20000,102,5,W
1929-09-03,0,BOS,10,5,2000,114,-5,NW
1929-09-04,0,BOS,1,5,2000,90,4,W
1929-09-07,0,BOS,3,4,3500,132,1,W
1929-09-08,1,BOS,3,4,0,118,1,W
1929-09-08,2,BOS,0,0,10000,96,0,NW
1929-09-09,0,BOS,2,6,350,90,4,W
1929-09-10,1,BOS,6,1,0,107,-5,NW
1929-09-10,2,BOS,1,0,3000,101,-1,NW
1929-09-11,0,BOS,7,8,2000,139,1,W
1929-09-12,0,BOS,2,1,2500,106,-1,NW
1929-09-14,0,BOS,2,1,3000,102,-1,NW
1929-09-15,1,BOS,4,5,0,108,1,W
1929-09-15,2,BOS,3,2,16000,105,-1,NW
1929-09-16,0,BOS,3,4,3000,91,1,W
1929-09-17,0,BOS,4,6,2000,104,2,W
1929-09-19,0,BOS,2,3,2000,90,1,W
1929-09-20,0,BOS,4,2,1500,119,-2,NW
1929-09-21,0,BOS,3,4,2500,150,1,W
1929-09-22,0,BOS,7,4,4000,130,-3,NW
1929-09-24,0,BOS,5,3,7000,119,-2,NW
1929-09-25,0,BOS,11,10,6000,180,-1,NW
1929-09-26,0,BOS,5,3,5000,103,-2,NW
1929-09-28,0,BOS,6,3,5000,115,-3,NW
1929-09-29,0,BOS,0,10,12000,88,10,W
1930-04-15,0,BOS,6,1,7500,98,-5,NW
1930-04-16,0,BOS,5,4,3000,94,-1,NW
1930-04-19,1,BOS,3,4,8000,194,1,W
1930-04-19,2,BOS,2,7,25000,103,5,W
1930-04-20,0,BOS,5,3,22000,113,-2,NW
1930-04-28,0,BOS,5,4,6000,120,-1,NW
1930-04-29,0,BOS,9,5,6000,128,-4,NW
1930-04-30,0,BOS,3,7,4000,106,4,W
1930-05-02,0,BOS,8,3,6100,108,-5,NW
1930-05-03,0,BOS,6,5,8000,130,-1,NW
1930-05-04,0,BOS,8,7,11000,144,-1,NW
1930-05-05,0,BOS,3,18,3000,123,15,W
1930-05-06,0,BOS,4,3,7000,103,-1,NW
1930-05-07,0,BOS,4,6,4000,115,2,W
1930-05-08,0,BOS,1,3,4500,95,2,W
1930-05-09,0,BOS,2,5,8500,113,3,W
1930-05-10,0,BOS,0,2,15000,83,2,W
1930-05-11,0,BOS,1,2,25000,110,1,W
1930-05-12,0,BOS,3,2,4000,133,-1,NW
1930-05-13,0,BOS,4,1,3500,118,-3,NW
1930-05-16,0,BOS,4,5,8700,128,1,W
1930-05-17,0,BOS,3,2,25000,128,-1,NW
1930-05-18,0,BOS,11,0,20000,114,-11,NW
1930-05-20,0,BOS,7,4,1500,138,-3,NW
1930-06-19,0,BOS,1,4,2500,100,3,W
1930-06-20,0,BOS,4,3,3000,116,-1,NW
1930-06-21,0,BOS,2,3,7000,94,1,W
1930-06-22,1,BOS,5,3,0,113,-2,NW
1930-06-22,2,BOS,4,2,17000,84,-2,NW
1930-06-23,0,BOS,0,2,3000,102,2,W
1930-06-24,1,BOS,4,5,0,100,1,W
1930-06-24,2,BOS,8,7,5000,148,-1,NW
1930-06-25,0,BOS,4,3,2500,114,-1,NW
1930-06-26,0,BOS,7,9,3500,112,2,W
1930-06-28,0,BOS,2,4,5500,95,2,W
1930-06-29,1,BOS,6,10,0,122,4,W
1930-06-29,2,BOS,2,1,14000,89,-1,NW
1930-06-30,0,BOS,8,3,2500,115,-5,NW
1930-07-01,0,BOS,1,3,4000,96,2,W
1930-07-02,0,BOS,4,5,5000,106,1,W
1930-07-04,1,BOS,6,7,0,135,1,W
1930-07-04,2,BOS,4,2,32000,95,-2,NW
1930-07-05,0,BOS,7,2,12000,120,-5,NW
1930-07-06,0,BOS,4,3,4200,128,-1,NW
1930-07-07,0,BOS,8,1,6000,115,-7,NW
1930-07-08,0,BOS,6,5,4000,116,-1,NW
1930-07-09,1,BOS,5,2,0,105,-3,NW
1930-07-09,2,BOS,1,5,14000,107,4,W
1930-07-10,0,BOS,7,2,4000,118,-5,NW
1930-07-30,1,BOS,8,2,0,119,-6,NW
1930-07-30,2,BOS,10,1,21000,120,-9,NW
1930-07-31,0,BOS,14,13,6000,165,-1,NW
1930-08-01,0,BOS,4,1,5000,100,-3,NW
1930-08-08,0,BOS,6,8,2500,132,2,W
1930-08-09,0,BOS,3,0,4000,100,-3,NW
1930-08-10,0,BOS,4,2,5000,111,-2,NW
1930-08-11,0,BOS,1,5,6000,99,4,W
1930-08-12,0,BOS,4,5,3000,118,1,W
1930-08-13,0,BOS,7,2,14000,114,-5,NW
1930-08-14,0,BOS,0,3,2000,83,3,W
1930-08-17,1,BOS,9,3,0,127,-6,NW
1930-08-17,2,BOS,2,0,12000,83,-2,NW
1930-08-19,1,BOS,7,2,0,120,-5,NW
1930-08-19,2,BOS,7,3,7500,120,-4,NW
1930-08-21,0,BOS,2,4,5000,91,2,W
1930-08-22,0,BOS,6,4,5000,89,-2,NW
1930-08-24,1,BOS,0,2,0,69,2,W
1930-08-24,2,BOS,5,4,10000,119,-1,NW
1930-08-28,0,BOS,1,2,15000,88,1,W
1930-08-30,0,BOS,11,0,12000,105,-11,NW
1930-08-31,0,BOS,2,1,10000,100,-1,NW
1930-09-24,0,BOS,3,6,1200,86,3,W
1930-09-25,0,BOS,3,2,1000,86,-1,NW
1930-09-26,0,BOS,1,7,3000,89,6,W
1930-09-27,0,BOS,8,3,2000,99,-5,NW
1930-09-28,0,BOS,9,3,12000,100,-6,NW
1931-04-22,0,BOS,7,5,13000,128,-2,NW
1931-04-24,0,BOS,7,4,7000,115,-3,NW
1931-04-25,0,BOS,4,5,8000,152,1,W
1931-05-01,0,BOS,4,10,3000,126,6,W
1931-05-02,1,BOS,6,2,0,130,-4,NW
1931-05-02,2,BOS,2,3,12000,114,1,W
1931-05-26,0,BOS,4,6,3500,118,2,W
1931-05-27,1,BOS,11,3,0,107,-8,NW
1931-05-27,2,BOS,4,3,7000,110,-1,NW
1931-05-28,0,BOS,4,3,6000,105,-1,NW
1931-05-30,1,BOS,5,0,0,148,-5,NW
1931-05-30,2,BOS,5,6,25000,107,1,W
1931-05-31,1,BOS,7,4,0,95,-3,NW
1931-05-31,2,BOS,3,7,20000,105,4,W
1931-06-02,0,BOS,12,11,2500,148,-1,NW
1931-06-03,0,BOS,5,4,5000,135,-1,NW
1931-06-04,0,BOS,10,2,3000,118,-8,NW
1931-06-05,0,BOS,3,4,2500,123,1,W
1931-06-06,0,BOS,8,9,12000,134,1,W
1931-06-07,0,BOS,3,6,3000,115,3,W
1931-06-08,0,BOS,4,0,2000,105,-4,NW
1931-06-12,0,BOS,1,3,5000,95,2,W
1931-06-13,0,BOS,1,7,10000,106,6,W
1931-06-14,0,BOS,7,4,8000,102,-3,NW
1931-06-15,0,BOS,2,3,3000,115,1,W
1931-07-12,1,BOS,7,2,0,119,-5,NW
1931-07-12,2,BOS,6,2,22500,81,-4,NW
1931-07-14,0,BOS,5,3,2000,123,-2,NW
1931-07-15,1,BOS,4,5,0,154,1,W
1931-07-15,2,BOS,5,2,5000,104,-3,NW
1931-07-16,0,BOS,2,1,4000,95,-1,NW
1931-07-17,0,BOS,6,2,2000,114,-4,NW
1931-07-18,0,BOS,1,4,5000,110,3,W
1931-07-19,0,BOS,5,6,5000,145,1,W
1931-07-20,0,BOS,9,2,2000,115,-7,NW
1931-07-21,0,BOS,2,3,2000,120,1,W
1931-07-22,1,BOS,2,3,0,107,1,W
1931-07-22,2,BOS,9,3,4000,104,-6,NW
1931-07-23,0,BOS,4,13,3000,115,9,W
1931-07-24,0,BOS,3,1,2500,93,-2,NW
1931-07-25,0,BOS,7,5,10000,120,-2,NW
1931-07-26,1,BOS,6,7,0,130,1,W
1931-07-26,2,BOS,7,3,10000,115,-4,NW
1931-07-27,0,BOS,4,13,1500,111,9,W
1931-07-28,0,BOS,1,8,2000,99,7,W
1931-07-29,1,BOS,4,5,0,125,1,W
1931-07-29,2,BOS,8,6,2500,130,-2,NW
1931-07-31,0,BOS,4,1,8000,130,-3,NW
1931-08-01,0,BOS,2,9,12000,113,7,W
1931-08-02,1,BOS,4,1,0,121,-3,NW
1931-08-02,2,BOS,0,1,40000,77,1,W
1931-08-03,0,BOS,9,8,5000,136,-1,NW
1931-08-05,1,BOS,1,5,0,125,4,W
1931-08-05,2,BOS,4,1,21000,108,-3,NW
1931-08-29,1,BOS,1,3,0,94,2,W
1931-08-29,2,BOS,2,3,10000,97,1,W
1931-08-30,0,BOS,14,4,22128,123,-10,NW
1931-09-04,1,BOS,2,0,0,98,-2,NW
1931-09-04,2,BOS,6,1,11618,92,-5,NW
1931-09-05,1,BOS,8,0,0,110,-8,NW
1931-09-05,2,BOS,3,6,7000,105,3,W
1931-09-06,0,BOS,5,3,7000,74,-2,NW
1931-09-07,1,BOS,7,5,0,125,-2,NW
1931-09-07,2,BOS,15,1,17000,102,-14,NW
1931-09-10,0,BOS,3,0,2000,85,-3,NW
1931-09-11,0,BOS,0,5,4500,87,5,W
1931-09-12,0,BOS,0,1,4000,141,1,W
1931-09-13,1,BOS,6,5,0,129,-1,NW
1931-09-13,2,BOS,2,2,7500,140,0,NW
1931-09-14,0,BOS,8,12,1500,109,4,W
1931-09-15,0,BOS,2,3,2000,108,1,W
1931-09-16,0,BOS,1,2,2000,74,1,W
1931-09-17,1,BOS,2,9,0,91,7,W
1931-09-17,2,BOS,2,1,1500,86,-1,NW
1931-09-18,1,BOS,1,6,0,110,5,W
1931-09-18,2,BOS,4,6,4200,100,2,W
1931-09-19,0,BOS,1,2,3500,102,1,W
1931-09-21,1,BOS,0,2,0,98,2,W
1931-09-21,2,BOS,2,9,2500,115,7,W
1931-09-22,0,BOS,5,2,2000,87,-3,NW
1932-04-13,0,BOS,7,6,4000,118,-1,NW
1932-04-15,0,BOS,2,0,1500,109,-2,NW
1932-04-16,0,BOS,14,4,7000,135,-10,NW
1932-04-19,1,BOS,5,6,2000,118,1,W
1932-04-19,2,BOS,6,3,18000,106,-3,NW
1932-05-02,0,BOS,3,2,2500,141,-1,NW
1932-05-03,0,BOS,6,1,3000,117,-5,NW
1932-05-05,0,BOS,11,3,3000,114,-8,NW
1932-05-06,0,BOS,6,5,2000,117,-1,NW
1932-05-07,0,BOS,4,0,3000,116,-4,NW
1932-05-08,0,BOS,5,7,5000,120,2,W
1932-05-10,0,BOS,11,0,1500,116,-11,NW
1932-05-12,0,BOS,5,4,1000,133,-1,NW
1932-05-14,0,BOS,6,0,5000,124,-6,NW
1932-05-15,0,BOS,9,2,6000,91,-7,NW
1932-05-16,0,BOS,4,3,1000,115,-1,NW
1932-05-17,0,BOS,7,3,6000,115,-4,NW
1932-05-18,0,BOS,10,13,2000,154,3,W
1932-05-26,0,BOS,7,1,1000,80,-6,NW
1932-05-28,0,BOS,8,2,2000,102,-6,NW
1932-05-29,1,BOS,4,6,0,123,2,W
1932-05-29,2,BOS,3,0,3000,102,-3,NW
1932-06-01,0,BOS,2,1,2000,120,-1,NW
1932-06-02,1,BOS,6,4,NA,140,-2,NW
1932-06-02,2,BOS,8,1,2500,108,-7,NW
1932-06-04,1,BOS,2,4,0,117,2,W
1932-06-04,2,BOS,8,9,6000,140,1,W
1932-06-30,0,BOS,15,4,2500,127,-11,NW
1932-07-01,0,BOS,6,11,4000,135,5,W
1932-07-02,1,BOS,8,5,0,140,-3,NW
1932-07-02,2,BOS,5,6,7000,122,1,W
1932-07-03,0,BOS,13,2,7000,148,-11,NW
1932-07-06,0,BOS,4,5,1500,121,1,W
1932-07-07,0,BOS,8,2,2000,124,-6,NW
1932-07-08,0,BOS,8,4,2500,100,-4,NW
1932-07-09,0,BOS,2,4,2000,101,2,W
1932-07-10,1,BOS,7,5,0,140,-2,NW
1932-07-10,2,BOS,2,13,10000,118,11,W
1932-07-11,0,BOS,5,3,2000,125,-2,NW
1932-07-12,0,BOS,2,3,2000,110,1,W
1932-07-13,0,BOS,7,8,2000,122,1,W
1932-07-14,0,BOS,9,8,3000,160,-1,NW
1932-07-15,0,BOS,4,2,5000,132,-2,NW
1932-07-16,0,BOS,0,3,4000,95,3,W
1932-07-17,1,BOS,5,4,0,112,-1,NW
1932-07-17,2,BOS,8,6,10000,137,-2,NW
1932-07-18,0,BOS,2,4,2000,102,2,W
1932-07-19,0,BOS,7,0,2000,110,-7,NW
1932-07-20,0,BOS,8,1,2000,113,-7,NW
1932-08-12,0,BOS,1,2,3500,94,1,W
1932-08-13,1,BOS,13,2,0,128,-11,NW
1932-08-13,2,BOS,8,2,8000,119,-6,NW
1932-08-14,1,BOS,6,1,0,96,-5,NW
1932-08-14,2,BOS,0,2,7500,92,2,W
1932-08-16,0,BOS,3,2,1000,100,-1,NW
1932-08-17,0,BOS,3,7,1000,107,4,W
1932-08-18,0,BOS,6,7,NA,203,1,W
1932-08-20,0,BOS,4,1,2000,120,-3,NW
1932-08-21,1,BOS,1,3,0,110,2,W
1932-08-21,2,BOS,4,2,7500,110,-2,NW
1932-08-22,0,BOS,5,6,2000,114,1,W
1932-08-23,0,BOS,5,4,2000,145,-1,NW
1932-08-24,0,BOS,7,3,1000,102,-4,NW
1932-08-25,0,BOS,4,5,2000,119,1,W
1932-08-26,0,BOS,8,11,5000,150,3,W
1932-08-27,0,BOS,10,13,3500,152,3,W
1932-08-28,1,BOS,10,1,0,115,-9,NW
1932-08-28,2,BOS,3,4,10000,140,1,W
1932-08-29,0,BOS,6,3,1000,108,-3,NW
1932-08-30,0,BOS,2,6,1200,112,4,W
1932-09-20,0,BOS,4,1,1000,98,-3,NW
1932-09-21,1,BOS,1,0,0,118,-1,NW
1932-09-21,2,BOS,3,2,700,110,-1,NW
1932-09-22,0,BOS,4,2,1000,97,-2,NW
1932-09-23,0,BOS,3,0,6000,99,-3,NW
1932-09-24,0,BOS,8,2,7000,109,-6,NW
1932-09-25,0,BOS,3,8,7000,107,5,W
1933-04-21,0,BOS,7,5,18000,128,-2,NW
1933-04-22,0,BOS,2,1,8000,113,-1,NW
1933-04-23,0,BOS,5,7,9000,128,2,W
1933-04-24,0,BOS,16,10,3000,140,-6,NW
1933-04-25,0,BOS,4,6,1000,116,2,W
1933-04-27,0,BOS,3,2,4000,132,-1,NW
1933-05-16,0,BOS,3,2,3500,134,-1,NW
1933-05-17,0,BOS,3,7,3000,120,4,W
1933-05-18,0,BOS,8,2,3000,138,-6,NW
1933-05-19,0,BOS,7,5,3000,118,-2,NW
1933-05-20,0,BOS,5,6,8000,149,1,W
1933-05-21,0,BOS,0,2,4500,105,2,W
1933-05-22,0,BOS,2,3,3000,105,1,W
1933-05-23,0,BOS,7,0,3000,115,-7,NW
1933-05-25,0,BOS,3,2,3500,111,-1,NW
1933-05-26,0,BOS,5,6,4500,133,1,W
1933-05-27,0,BOS,6,0,3000,107,-6,NW
1933-05-28,1,BOS,2,5,0,135,3,W
1933-05-28,2,BOS,11,2,19000,115,-9,NW
1933-05-30,1,BOS,7,3,0,114,-4,NW
1933-05-30,2,BOS,11,8,10000,184,-3,NW
1933-06-08,1,BOS,3,4,0,115,1,W
1933-06-08,2,BOS,12,3,4500,116,-9,NW
1933-06-09,0,BOS,7,2,3000,105,-5,NW
1933-06-10,0,BOS,7,5,5000,114,-2,NW
1933-06-11,1,BOS,8,7,0,166,-1,NW
1933-06-11,2,BOS,9,11,30000,95,2,W
1933-06-13,0,BOS,5,6,2000,111,1,W
1933-06-14,0,BOS,5,13,3500,158,8,W
1933-06-15,0,BOS,5,8,5000,156,3,W
1933-06-17,1,BOS,15,3,0,140,-12,NW
1933-06-17,2,BOS,5,7,18000,120,2,W
1933-07-08,0,BOS,4,1,3500,118,-3,NW
1933-07-09,1,BOS,0,4,0,116,4,W
1933-07-09,2,BOS,9,2,5500,119,-7,NW
1933-07-10,0,BOS,9,5,3000,103,-4,NW
1933-07-11,0,BOS,1,2,2500,104,1,W
1933-07-12,0,BOS,0,1,3000,119,1,W
1933-07-13,0,BOS,3,2,3000,119,-1,NW
1933-07-14,0,BOS,8,3,3000,119,-5,NW
1933-07-15,0,BOS,2,7,3500,115,5,W
1933-07-16,0,BOS,2,1,6000,165,-1,NW
1933-07-18,0,BOS,2,1,3000,90,-1,NW
1933-07-19,0,BOS,8,7,3000,175,-1,NW
1933-07-20,0,BOS,0,5,3000,96,5,W
1933-07-21,0,BOS,2,12,3000,115,10,W
1933-07-22,0,BOS,3,5,2000,106,2,W
1933-07-23,1,BOS,2,6,0,115,4,W
1933-07-23,2,BOS,2,7,20000,120,5,W
1933-07-26,1,BOS,2,0,0,120,-2,NW
1933-07-26,2,BOS,4,9,24373,114,5,W
1933-07-27,0,BOS,2,6,3500,116,4,W
1933-07-29,0,BOS,1,8,5000,118,7,W
1933-07-30,0,BOS,3,8,10000,110,5,W
1933-08-10,0,BOS,5,3,5000,121,-2,NW
1933-08-11,0,BOS,8,4,5000,155,-4,NW
1933-08-12,0,BOS,2,1,6000,105,-1,NW
1933-08-13,0,BOS,10,19,7500,121,9,W
1933-09-05,1,BOS,5,4,0,142,-1,NW
1933-09-05,2,BOS,9,6,5000,140,-3,NW
1933-09-06,0,BOS,11,5,1000,125,-6,NW
1933-09-08,1,BOS,4,3,0,115,-1,NW
1933-09-08,2,BOS,4,3,4500,120,-1,NW
1933-09-09,0,BOS,4,6,2000,117,2,W
1933-09-10,1,BOS,3,2,0,120,-1,NW
1933-09-10,2,BOS,4,0,8000,152,-4,NW
1933-09-12,0,BOS,4,1,1000,110,-3,NW
1933-09-13,0,BOS,1,3,1000,103,2,W
1933-09-18,0,BOS,9,0,1200,114,-9,NW
1933-09-19,0,BOS,3,4,1500,97,1,W
1933-09-23,0,BOS,16,12,6000,145,-4,NW
1933-09-24,0,BOS,8,10,7000,142,2,W
1934-04-17,0,BOS,6,5,33336,156,-1,NW
1934-04-18,0,BOS,5,4,7451,118,-1,NW
1934-04-19,1,BOS,4,5,5500,135,1,W
1934-04-19,2,BOS,3,7,33456,132,4,W
1934-04-21,0,BOS,6,9,24832,155,3,W
1934-04-22,0,BOS,8,1,44631,123,-7,NW
1934-04-30,0,BOS,6,2,5100,128,-4,NW
1934-05-01,0,BOS,2,7,6000,135,5,W
1934-05-02,0,BOS,12,11,6500,158,-1,NW
1934-05-04,0,BOS,1,4,5000,128,3,W
1934-05-05,0,BOS,12,13,15000,163,1,W
1934-05-06,0,BOS,4,14,30000,146,10,W
1934-05-07,0,BOS,8,6,4000,161,-2,NW
1934-05-08,0,BOS,5,1,3500,127,-4,NW
1934-05-09,0,BOS,4,5,4100,152,1,W
1934-05-10,0,BOS,11,10,3500,180,-1,NW
1934-05-11,0,BOS,6,5,5100,183,-1,NW
1934-05-12,0,BOS,7,2,10000,146,-5,NW
1934-05-13,0,BOS,2,14,15000,122,12,W
1934-05-14,0,BOS,8,2,NA,108,-6,NW
1934-06-05,0,BOS,3,8,6500,122,5,W
1934-06-06,1,BOS,15,3,0,127,-12,NW
1934-06-06,2,BOS,4,7,21550,140,3,W
1934-06-08,0,BOS,2,3,5400,175,1,W
1934-06-09,0,BOS,8,1,14000,110,-7,NW
1934-06-10,0,BOS,3,4,18000,119,1,W
1934-06-12,0,BOS,4,2,4000,119,-2,NW
1934-06-13,0,BOS,13,15,3000,148,2,W
1934-06-15,0,BOS,11,4,5600,138,-7,NW
1934-06-16,0,BOS,2,3,7500,135,1,W
1934-06-17,1,BOS,10,7,0,178,-3,NW
1934-06-17,2,BOS,3,6,27284,100,3,W
1934-06-18,1,BOS,5,6,0,134,1,W
1934-06-18,2,BOS,9,14,15968,170,5,W
1934-06-20,0,BOS,9,14,3585,135,5,W
1934-06-21,1,BOS,3,6,0,113,3,W
1934-06-21,2,BOS,4,1,10030,120,-3,NW
1934-06-22,0,BOS,1,11,9789,127,10,W
1934-06-23,0,BOS,2,10,5000,105,8,W
1934-06-24,0,BOS,6,2,19304,142,-4,NW
1934-06-25,0,BOS,3,6,3500,136,3,W
1934-06-26,0,BOS,10,2,4500,113,-8,NW
1934-06-27,0,BOS,0,6,3546,109,6,W
1934-07-04,1,BOS,5,8,0,149,3,W
1934-07-04,2,BOS,10,4,33819,126,-6,NW
1934-07-05,0,BOS,6,5,3500,130,-1,NW
1934-07-06,0,BOS,6,18,3633,138,12,W
1934-07-07,0,BOS,10,11,7000,155,1,W
1934-07-08,1,BOS,4,7,0,141,3,W
1934-07-08,2,BOS,2,7,24000,115,5,W
1934-08-04,0,BOS,7,5,8000,164,-2,NW
1934-08-05,1,BOS,2,1,0,110,-1,NW
1934-08-05,2,BOS,3,7,26262,125,4,W
1934-08-10,0,BOS,10,3,9109,136,-7,NW
1934-08-11,0,BOS,2,3,10000,170,1,W
1934-08-12,1,BOS,4,6,0,138,2,W
1934-08-12,2,BOS,7,1,46766,125,-6,NW
1934-08-14,0,BOS,3,7,4000,103,4,W
1934-08-15,0,BOS,2,6,3500,118,4,W
1934-08-17,1,BOS,0,6,0,117,6,W
1934-08-17,2,BOS,5,2,9076,109,-3,NW
1934-08-18,0,BOS,7,8,12862,129,1,W
1934-08-19,1,BOS,8,6,0,139,-2,NW
1934-08-19,2,BOS,4,3,46995,127,-1,NW
1934-08-21,0,BOS,8,4,15836,130,-4,NW
1934-08-22,0,BOS,2,3,4000,132,1,W
1934-08-23,0,BOS,7,2,2000,103,-5,NW
1934-08-25,1,BOS,3,2,0,137,-1,NW
1934-08-25,2,BOS,8,7,12500,159,-1,NW
1934-08-26,1,BOS,3,2,0,114,-1,NW
1934-08-26,2,BOS,2,5,17900,110,3,W
1934-08-27,0,BOS,6,5,2275,140,-1,NW
1934-08-28,0,BOS,2,8,1000,112,6,W
1934-09-25,1,BOS,0,1,0,91,1,W
1934-09-25,2,BOS,3,9,3500,115,6,W
1934-09-30,1,BOS,0,5,0,102,5,W
1934-09-30,2,BOS,4,2,6900,105,-2,NW
1935-04-23,0,BOS,4,7,15000,142,3,W
1935-04-25,0,BOS,12,4,9200,135,-8,NW
1935-04-26,0,BOS,10,5,9100,128,-5,NW
1935-04-27,0,BOS,8,3,15000,139,-5,NW
1935-04-28,0,BOS,5,3,23500,129,-2,NW
1935-05-17,0,BOS,1,2,5600,173,1,W
1935-05-18,0,BOS,3,2,8000,125,-1,NW
1935-05-19,0,BOS,6,5,21000,156,-1,NW
1935-05-20,0,BOS,4,1,3000,112,-3,NW
1935-05-21,0,BOS,2,7,3000,115,5,W
1935-05-22,0,BOS,5,12,5000,127,7,W
1935-05-23,0,BOS,5,3,3000,138,-2,NW
1935-05-24,0,BOS,4,8,11000,115,4,W
1935-05-25,0,BOS,3,2,13000,108,-1,NW
1935-05-26,0,BOS,7,8,16000,147,1,W
1935-05-27,0,BOS,5,3,2000,131,-2,NW
1935-05-28,0,BOS,6,5,1600,130,-1,NW
1935-05-29,0,BOS,9,10,2000,132,1,W
1935-05-30,1,BOS,4,7,0,118,3,W
1935-05-30,2,BOS,13,8,32000,197,-5,NW
1935-06-07,0,BOS,1,2,2500,109,1,W
1935-06-08,1,BOS,12,6,0,165,-6,NW
1935-06-08,2,BOS,2,4,25000,130,2,W
1935-07-01,0,BOS,3,8,3000,132,5,W
1935-07-02,0,BOS,5,6,3500,105,1,W
1935-07-03,0,BOS,7,14,3500,147,7,W
1935-07-06,0,BOS,4,6,10000,116,2,W
1935-07-07,1,BOS,6,7,0,185,1,W
1935-07-07,2,BOS,3,1,20000,96,-2,NW
1935-07-10,0,BOS,0,7,3500,114,7,W
1935-07-11,1,BOS,3,4,0,114,1,W
1935-07-11,2,BOS,10,2,15000,127,-8,NW
1935-07-12,0,BOS,13,2,3500,137,-11,NW
1935-07-13,0,BOS,4,2,5000,135,-2,NW
1935-07-14,1,BOS,3,14,0,125,11,W
1935-07-14,2,BOS,2,2,31500,133,0,NW
1935-07-17,1,BOS,5,13,0,143,8,W
1935-07-17,2,BOS,1,3,16000,119,2,W
1935-07-18,0,BOS,8,0,4000,120,-8,NW
1935-07-19,0,BOS,9,7,8000,150,-2,NW
1935-07-20,0,BOS,6,5,7000,127,-1,NW
1935-07-21,0,BOS,6,7,24000,124,1,W
1935-07-22,0,BOS,1,2,1600,111,1,W
1935-07-23,0,BOS,7,2,2800,119,-5,NW
1935-07-24,0,BOS,6,3,3000,131,-3,NW
1935-08-03,0,BOS,4,5,7000,157,1,W
1935-08-04,1,BOS,6,7,0,156,1,W
1935-08-04,2,BOS,4,3,40000,107,-1,NW
1935-08-05,0,BOS,10,2,2300,103,-8,NW
1935-08-07,1,BOS,5,6,0,130,1,W
1935-08-07,2,BOS,6,4,20000,143,-2,NW
1935-08-10,0,BOS,8,9,6000,130,1,W
1935-08-11,1,BOS,4,2,0,104,-2,NW
1935-08-11,2,BOS,4,5,35000,116,1,W
1935-09-02,1,BOS,8,9,0,146,1,W
1935-09-02,2,BOS,3,2,25000,172,-1,NW
1935-09-05,1,BOS,8,1,0,112,-7,NW
1935-09-05,2,BOS,1,6,7500,127,5,W
1935-09-07,1,BOS,5,3,0,132,-2,NW
1935-09-07,2,BOS,5,4,12500,133,-1,NW
1935-09-08,1,BOS,2,6,0,112,4,W
1935-09-08,2,BOS,2,5,23000,119,3,W
1935-09-10,0,BOS,3,4,3500,110,1,W
1935-09-11,0,BOS,10,2,3500,110,-8,NW
1935-09-12,0,BOS,6,2,4000,112,-4,NW
1935-09-13,1,BOS,4,13,0,137,9,W
1935-09-13,2,BOS,4,2,7500,105,-2,NW
1935-09-14,0,BOS,2,5,5000,125,3,W
1935-09-15,0,BOS,5,9,10000,127,4,W
1935-09-16,0,BOS,5,3,5000,127,-2,NW
1935-09-17,0,BOS,4,5,6500,122,1,W
1935-09-18,0,BOS,3,4,6000,110,1,W
1935-09-19,0,BOS,1,4,10000,114,3,W
1935-09-21,0,BOS,5,2,7500,122,-3,NW
1935-09-22,1,BOS,6,4,0,130,-2,NW
1935-09-22,2,BOS,9,0,47627,107,-9,NW
1935-09-24,1,BOS,2,8,0,122,6,W
1935-09-24,2,BOS,5,6,3500,120,1,W
1935-09-25,0,BOS,2,7,7500,96,5,W
1936-04-14,0,BOS,4,9,29100,150,5,W
1936-04-16,0,BOS,4,10,3600,136,6,W
1936-04-20,1,BOS,5,6,8300,118,1,W
1936-04-20,2,BOS,6,2,36400,106,-4,NW
1936-04-21,0,BOS,1,8,5000,88,7,W
1936-04-22,0,BOS,3,4,5300,116,1,W
1936-04-25,0,BOS,2,7,15600,125,5,W
1936-04-26,0,BOS,12,9,12200,160,-3,NW
1936-04-28,0,BOS,8,11,5000,118,3,W
1936-04-29,0,BOS,7,8,9500,133,1,W
1936-04-30,0,BOS,4,16,6200,150,12,W
1936-05-01,0,BOS,0,6,25000,115,6,W
1936-05-02,0,BOS,7,3,21000,145,-4,NW
1936-05-03,0,BOS,0,6,30800,104,6,W
1936-05-05,0,BOS,0,2,16100,103,2,W
1936-05-06,0,BOS,4,7,4200,132,3,W
1936-05-07,0,BOS,6,9,3000,115,3,W
1936-05-23,0,BOS,8,7,24800,178,-1,NW
1936-05-24,0,BOS,12,4,26200,138,-8,NW
1936-05-25,0,BOS,0,6,2800,97,6,W
1936-05-26,0,BOS,4,5,13600,132,1,W
1936-05-27,0,BOS,9,8,11200,173,-1,NW
1936-05-28,0,BOS,10,6,11200,149,-4,NW
1936-06-02,0,BOS,6,14,6000,143,8,W
1936-06-03,0,BOS,2,6,7500,122,4,W
1936-06-04,0,BOS,3,4,6500,138,1,W
1936-06-05,0,BOS,6,8,13000,128,2,W
1936-06-06,0,BOS,6,10,16000,150,4,W
1936-06-07,0,BOS,13,5,26500,135,-8,NW
1936-06-08,1,BOS,3,6,0,133,3,W
1936-06-08,2,BOS,12,7,23500,150,-5,NW
1936-06-09,0,BOS,8,4,4500,125,-4,NW
1936-06-10,0,BOS,3,4,4500,91,1,W
1936-06-11,0,BOS,5,7,3500,126,2,W
1936-07-04,1,BOS,0,1,0,108,1,W
1936-07-04,2,BOS,4,5,25000,133,1,W
1936-07-05,1,BOS,2,16,0,110,14,W
1936-07-05,2,BOS,2,8,19000,140,6,W
1936-07-09,0,BOS,2,7,3000,120,5,W
1936-07-10,0,BOS,8,2,8000,141,-6,NW
1936-07-11,0,BOS,9,1,3500,122,-8,NW
1936-07-12,0,BOS,5,2,13500,126,-3,NW
1936-07-13,0,BOS,11,3,2500,134,-8,NW
1936-07-14,0,BOS,5,1,2496,127,-4,NW
1936-07-15,1,BOS,3,11,0,130,8,W
1936-07-15,2,BOS,1,9,5000,124,8,W
1936-07-16,1,BOS,6,3,0,111,-3,NW
1936-07-16,2,BOS,4,5,5200,117,1,W
1936-07-17,0,BOS,1,2,7000,131,1,W
1936-07-18,0,BOS,6,5,8000,127,-1,NW
1936-07-19,0,BOS,3,12,18000,135,9,W
1936-08-04,0,BOS,4,2,7500,115,-2,NW
1936-08-05,0,BOS,7,2,7500,126,-5,NW
1936-08-11,0,BOS,1,4,1800,118,3,W
1936-08-12,1,BOS,4,6,0,118,2,W
1936-08-12,2,BOS,6,0,8000,105,-6,NW
1936-08-14,0,BOS,0,9,7300,109,9,W
1936-08-15,0,BOS,11,5,3500,145,-6,NW
1936-08-16,1,BOS,7,6,0,132,-1,NW
1936-08-16,2,BOS,3,2,16500,127,-1,NW
1936-08-25,0,BOS,5,0,3200,106,-5,NW
1936-08-26,0,BOS,0,7,5000,110,7,W
1936-08-27,0,BOS,4,2,3600,126,-2,NW
1936-08-28,1,BOS,8,1,0,108,-7,NW
1936-08-28,2,BOS,1,2,11000,100,1,W
1936-08-30,1,BOS,2,3,0,120,1,W
1936-08-30,2,BOS,1,5,21000,107,4,W
1936-09-01,0,BOS,1,4,2500,110,3,W
1936-09-03,1,BOS,3,2,0,98,-1,NW
1936-09-03,2,BOS,0,5,4000,119,5,W
1936-09-04,0,BOS,9,6,12000,120,-3,NW
1936-09-05,1,BOS,2,3,0,115,1,W
1936-09-05,2,BOS,7,7,21000,180,0,NW
1936-09-06,1,BOS,5,14,0,127,9,W
1936-09-06,2,BOS,2,4,31000,101,2,W
1936-09-27,1,BOS,8,4,0,115,-4,NW
1936-09-27,2,BOS,4,5,4000,100,1,W
1937-04-24,0,BOS,6,5,25000,165,-1,NW
1937-04-25,0,BOS,9,3,35000,155,-6,NW
1937-04-26,0,BOS,5,12,3000,140,7,W
1937-04-30,0,BOS,5,15,5200,140,10,W
1937-05-18,0,BOS,7,4,3200,150,-3,NW
1937-05-20,0,BOS,16,5,1603,158,-11,NW
1937-05-21,0,BOS,4,2,6000,121,-2,NW
1937-05-22,0,BOS,9,11,7000,140,2,W
1937-05-23,0,BOS,6,4,20000,155,-2,NW
1937-05-24,0,BOS,5,9,3500,120,4,W
1937-05-25,0,BOS,2,4,3500,85,2,W
1937-05-26,0,BOS,9,11,4000,145,2,W
1937-05-28,0,BOS,0,7,5000,124,7,W
1937-05-29,0,BOS,2,4,7200,113,2,W
1937-05-30,0,BOS,11,4,16000,121,-7,NW
1937-05-31,1,BOS,4,3,0,126,-1,NW
1937-05-31,2,BOS,2,8,40100,112,6,W
1937-06-15,0,BOS,1,5,3400,114,4,W
1937-06-16,0,BOS,2,3,4200,149,1,W
1937-06-17,1,BOS,2,5,0,120,3,W
1937-06-17,2,BOS,2,3,17000,140,1,W
1937-06-18,0,BOS,4,5,4500,128,1,W
1937-06-20,1,BOS,2,5,0,108,3,W
1937-06-20,2,BOS,8,7,37195,143,-1,NW
1937-06-23,0,BOS,5,6,7200,124,1,W
1937-06-24,0,BOS,0,9,7500,100,9,W
1937-06-25,0,BOS,2,4,5200,111,2,W
1937-06-26,0,BOS,7,1,2400,116,-6,NW
1937-06-27,1,BOS,0,8,0,107,8,W
1937-06-27,2,BOS,7,11,22000,130,4,W
1937-07-02,0,BOS,4,8,8300,132,4,W
1937-07-03,0,BOS,3,8,4500,126,5,W
1937-07-04,1,BOS,6,7,0,150,1,W
1937-07-04,2,BOS,2,4,26000,125,2,W
1937-07-27,0,BOS,8,5,2000,115,-3,NW
1937-07-28,0,BOS,4,5,3200,130,1,W
1937-07-29,0,BOS,3,5,2600,110,2,W
1937-07-30,0,BOS,5,6,6800,156,1,W
1937-07-31,0,BOS,1,12,7200,118,11,W
1937-08-01,1,BOS,4,11,0,115,7,W
1937-08-01,2,BOS,2,2,34000,134,0,NW
1937-08-03,0,BOS,2,13,4200,129,11,W
1937-08-04,1,BOS,6,8,0,136,2,W
1937-08-04,2,BOS,5,6,15000,128,1,W
1937-08-05,0,BOS,4,5,3100,137,1,W
1937-08-06,0,BOS,3,7,6000,137,4,W
1937-08-07,0,BOS,4,5,8000,128,1,W
1937-08-08,1,BOS,6,7,0,148,1,W
1937-08-08,2,BOS,13,0,28000,110,-13,NW
1937-08-11,1,BOS,8,5,0,231,-3,NW
1937-08-11,2,BOS,10,4,36127,123,-6,NW
1937-08-12,1,BOS,10,16,0,178,6,W
1937-08-12,2,BOS,5,3,20383,110,-2,NW
1937-08-20,0,BOS,3,1,3500,140,-2,NW
1937-09-04,1,BOS,4,5,NA,155,1,W
1937-09-04,2,BOS,10,4,6300,117,-6,NW
1937-09-06,1,BOS,2,6,NA,125,4,W
1937-09-06,2,BOS,2,0,19000,120,-2,NW
1937-09-07,1,BOS,11,5,0,122,-6,NW
1937-09-07,2,BOS,5,4,5000,118,-1,NW
1937-09-15,0,BOS,5,3,3400,127,-2,NW
1937-09-17,0,BOS,4,1,1400,100,-3,NW
1937-09-18,0,BOS,7,6,3300,133,-1,NW
1937-09-20,1,BOS,8,6,0,143,-2,NW
1937-09-20,2,BOS,5,7,1200,118,2,W
1937-09-21,1,BOS,7,12,0,123,5,W
1937-09-21,2,BOS,4,1,3500,110,-3,NW
1937-09-22,0,BOS,6,4,2500,142,-2,NW
1937-09-23,0,BOS,3,4,6500,117,1,W
1937-09-24,0,BOS,5,1,4200,118,-4,NW
1937-09-25,0,BOS,5,2,7500,116,-3,NW
1937-09-26,0,BOS,2,7,15000,120,5,W
1937-09-27,1,BOS,2,6,0,119,4,W
1937-09-27,2,BOS,6,0,1500,90,-6,NW
1938-04-18,0,BOS,4,8,10500,130,4,W
1938-04-19,1,BOS,5,3,10000,114,-2,NW
1938-04-19,2,BOS,0,6,33000,113,6,W
1938-04-21,0,BOS,2,3,9000,138,1,W
1938-05-01,0,BOS,8,6,17200,135,-2,NW
1938-05-02,0,BOS,1,13,4000,115,12,W
1938-05-03,0,BOS,3,4,4500,163,1,W
1938-05-04,0,BOS,4,1,6600,120,-3,NW
1938-05-05,0,BOS,7,5,5500,157,-2,NW
1938-05-06,0,BOS,3,7,1700,135,4,W
1938-05-07,0,BOS,2,7,4500,106,5,W
1938-05-08,0,BOS,0,5,33100,121,5,W
1938-05-09,0,BOS,3,15,6500,131,12,W
1938-05-11,0,BOS,2,4,5700,95,2,W
1938-05-13,0,BOS,0,10,6800,135,10,W
1938-05-14,0,BOS,9,10,15000,170,1,W
1938-05-15,0,BOS,3,4,26000,136,1,W
1938-06-01,0,BOS,3,6,3400,135,3,W
1938-06-02,0,BOS,1,6,3000,112,5,W
1938-06-04,0,BOS,3,5,9700,101,2,W
1938-06-05,0,BOS,10,4,29000,120,-6,NW
1938-06-06,0,BOS,7,8,4000,122,1,W
1938-06-07,0,BOS,7,5,7000,137,-2,NW
1938-06-08,0,BOS,6,7,5000,156,1,W
1938-06-09,0,BOS,0,8,12000,128,8,W
1938-06-10,0,BOS,15,2,7000,123,-13,NW
1938-06-12,1,BOS,2,3,0,110,1,W
1938-06-12,2,BOS,4,3,36000,100,-1,NW
1938-06-29,0,BOS,4,6,3500,101,2,W
1938-06-30,0,BOS,1,11,4400,101,10,W
1938-07-04,1,BOS,5,8,0,148,3,W
1938-07-04,2,BOS,2,5,18000,102,3,W
1938-07-08,0,BOS,8,9,26000,142,1,W
1938-07-09,0,BOS,11,6,17000,147,-5,NW
1938-07-10,0,BOS,4,6,27000,116,2,W
1938-07-13,1,BOS,4,7,0,118,3,W
1938-07-13,2,BOS,9,5,21000,120,-4,NW
1938-07-14,0,BOS,1,12,4200,125,11,W
1938-07-15,0,BOS,3,5,3200,116,2,W
1938-07-16,0,BOS,8,3,4900,132,-5,NW
1938-07-17,1,BOS,5,11,0,129,6,W
1938-07-17,2,BOS,4,14,14000,124,10,W
1938-07-22,0,BOS,4,7,6500,150,3,W
1938-07-25,1,BOS,0,4,0,112,4,W
1938-07-25,2,BOS,3,0,29000,115,-3,NW
1938-08-16,0,BOS,14,11,5200,152,-3,NW
1938-08-17,1,BOS,3,4,0,110,1,W
1938-08-17,2,BOS,0,5,3200,105,5,W
1938-08-18,0,BOS,0,2,2000,95,2,W
1938-08-19,0,BOS,3,4,4700,149,1,W
1938-08-20,0,BOS,7,10,6200,127,3,W
1938-08-21,1,BOS,5,4,0,130,-1,NW
1938-08-21,2,BOS,2,7,24500,108,5,W
1938-08-23,1,BOS,3,13,0,144,10,W
1938-08-23,2,BOS,12,14,18500,158,2,W
1938-08-24,0,BOS,5,3,7000,122,-2,NW
1938-08-25,1,BOS,0,1,0,100,1,W
1938-08-25,2,BOS,5,9,10000,150,4,W
1938-08-26,1,BOS,12,2,0,125,-10,NW
1938-08-26,2,BOS,8,9,14800,160,1,W
1938-08-27,1,BOS,6,19,0,130,13,W
1938-08-27,2,BOS,0,1,18000,98,1,W
1938-08-28,0,BOS,4,3,18000,137,-1,NW
1938-08-29,0,BOS,15,1,4500,120,-14,NW
1938-08-30,0,BOS,9,5,2800,137,-4,NW
1938-08-31,0,BOS,3,6,3000,120,3,W
1938-09-01,0,BOS,3,5,2200,115,2,W
1938-09-07,0,BOS,4,11,13000,88,7,W
1938-09-08,0,BOS,4,0,9500,115,-4,NW
1938-09-09,0,BOS,4,3,2200,125,-1,NW
1938-09-10,0,BOS,15,7,4200,136,-8,NW
1938-09-11,0,BOS,7,12,9000,140,5,W
1938-09-29,0,BOS,5,13,1800,105,8,W
1938-10-01,0,BOS,2,9,5000,100,7,W
1938-10-02,0,BOS,6,1,12000,91,-5,NW
1939-04-21,0,BOS,2,9,15000,111,7,W
1939-04-22,0,BOS,2,5,10300,120,3,W
1939-04-23,0,BOS,12,8,12000,175,-4,NW
1939-04-24,0,BOS,10,9,2000,173,-1,NW
1939-04-25,0,BOS,5,6,4000,173,1,W
1939-05-16,0,BOS,4,18,5800,127,14,W
1939-05-17,0,BOS,6,3,5200,125,-3,NW
1939-05-18,0,BOS,3,5,3500,115,2,W
1939-05-19,0,BOS,7,15,4800,130,8,W
1939-05-20,0,BOS,9,5,9800,149,-4,NW
1939-05-21,0,BOS,3,8,24000,130,5,W
1939-05-23,0,BOS,7,2,2500,130,-5,NW
1939-05-24,0,BOS,6,2,4000,111,-4,NW
1939-05-25,0,BOS,11,0,5600,125,-11,NW
1939-05-26,0,BOS,2,4,2600,106,2,W
1939-05-27,1,BOS,4,11,0,120,7,W
1939-05-27,2,BOS,6,7,14000,113,1,W
1939-05-28,0,BOS,7,12,12000,119,5,W
1939-05-29,0,BOS,6,1,17000,130,-5,NW
1939-05-30,1,BOS,4,8,0,120,4,W
1939-05-30,2,BOS,17,9,35000,142,-8,NW
1939-06-14,1,BOS,9,8,0,138,-1,NW
1939-06-14,2,BOS,6,2,7600,120,-4,NW
1939-06-15,0,BOS,6,3,3300,136,-3,NW
1939-06-16,0,BOS,8,7,3200,130,-1,NW
1939-06-18,1,BOS,4,5,0,154,1,W
1939-06-18,2,BOS,3,5,32000,105,2,W
1939-06-20,0,BOS,1,8,1500,100,7,W
1939-06-21,0,BOS,6,0,3400,111,-6,NW
1939-06-22,0,BOS,3,7,2400,114,4,W
1939-06-24,0,BOS,14,6,5500,142,-8,NW
1939-06-29,0,BOS,8,6,2000,121,-2,NW
1939-07-01,0,BOS,3,5,12000,118,2,W
1939-07-02,1,BOS,3,7,0,113,4,W
1939-07-02,2,BOS,9,3,35000,120,-6,NW
1939-07-25,1,BOS,2,3,0,117,1,W
1939-07-25,2,BOS,5,6,20000,136,1,W
1939-07-26,1,BOS,8,1,0,137,-7,NW
1939-07-26,2,BOS,5,6,21000,122,1,W
1939-07-27,0,BOS,12,7,4600,140,-5,NW
1939-07-28,0,BOS,11,6,3000,120,-5,NW
1939-07-29,0,BOS,4,3,4600,152,-1,NW
1939-07-30,0,BOS,4,6,9000,125,2,W
1939-08-01,0,BOS,5,7,11000,130,2,W
1939-08-02,1,BOS,8,2,0,135,-6,NW
1939-08-02,2,BOS,4,5,22000,118,1,W
1939-08-03,0,BOS,6,17,5000,145,11,W
1939-08-05,0,BOS,16,4,11000,145,-12,NW
1939-08-06,1,BOS,10,1,0,123,-9,NW
1939-08-06,2,BOS,3,8,35000,107,5,W
1939-08-08,0,BOS,2,9,3300,115,7,W
1939-08-09,1,BOS,3,5,0,123,2,W
1939-08-09,2,BOS,5,6,8500,122,1,W
1939-08-10,0,BOS,5,7,4000,112,2,W
1939-08-12,0,BOS,5,9,9500,135,4,W
1939-08-13,1,BOS,1,9,0,135,8,W
1939-08-13,2,BOS,6,3,30000,130,-3,NW
1939-09-02,0,BOS,7,12,12500,120,5,W
1939-09-03,1,BOS,11,12,0,148,1,W
1939-09-03,2,BOS,5,5,27000,126,0,NW
1939-09-04,1,BOS,7,6,0,120,-1,NW
1939-09-04,2,BOS,6,4,13000,120,-2,NW
1939-09-12,0,BOS,1,2,1800,109,1,W
1939-09-13,0,BOS,0,1,2400,96,1,W
1939-09-14,0,BOS,8,7,2400,125,-1,NW
1939-09-15,0,BOS,7,1,2300,125,-6,NW
1939-09-16,0,BOS,2,1,3400,102,-1,NW
1939-09-17,1,BOS,6,1,0,108,-5,NW
1939-09-17,2,BOS,7,11,12000,151,4,W
1939-09-19,0,BOS,2,6,1100,112,4,W
1939-09-20,0,BOS,11,8,1100,216,-3,NW
1939-09-21,0,BOS,2,6,600,125,4,W
1939-09-22,0,BOS,5,7,1000,115,2,W
1939-09-23,0,BOS,8,10,2100,133,2,W
1939-09-24,0,BOS,4,9,4600,125,5,W
1940-04-19,1,BOS,6,7,7100,142,1,W
1940-04-19,2,BOS,3,1,26500,126,-2,NW
1940-04-23,0,BOS,2,7,2000,110,5,W
1940-04-24,0,BOS,9,6,2700,148,-3,NW
1940-04-26,0,BOS,1,8,23200,118,7,W
1940-04-30,0,BOS,9,4,7600,114,-5,NW
1940-05-01,0,BOS,4,12,6800,134,8,W
1940-05-03,0,BOS,8,9,3900,157,1,W
1940-05-04,0,BOS,1,4,5300,130,3,W
1940-05-05,0,BOS,6,1,32500,136,-5,NW
1940-05-06,0,BOS,5,8,7000,118,3,W
1940-05-07,0,BOS,4,6,8500,131,2,W
1940-05-08,0,BOS,4,5,3800,135,1,W
1940-05-09,0,BOS,5,6,7700,152,1,W
1940-05-26,0,BOS,7,2,14800,130,-5,NW
1940-06-01,0,BOS,1,2,9500,118,1,W
1940-06-02,1,BOS,6,0,0,119,-6,NW
1940-06-02,2,BOS,8,10,33500,145,2,W
1940-06-03,0,BOS,7,4,4000,131,-3,NW
1940-06-04,0,BOS,5,3,3100,180,-2,NW
1940-06-05,0,BOS,4,3,3200,200,-1,NW
1940-06-06,0,BOS,1,3,3100,102,2,W
1940-06-07,0,BOS,7,1,1170,134,-6,NW
1940-06-08,0,BOS,4,2,10900,124,-2,NW
1940-06-11,0,BOS,2,9,10000,140,7,W
1940-06-12,0,BOS,5,9,7200,141,4,W
1940-06-28,0,BOS,4,3,6100,144,-1,NW
1940-06-29,0,BOS,9,7,5800,140,-2,NW
1940-06-30,1,BOS,5,6,0,115,1,W
1940-06-30,2,BOS,4,5,23000,127,1,W
1940-07-01,0,BOS,9,1,2200,120,-8,NW
1940-07-02,1,BOS,4,3,0,130,-1,NW
1940-07-02,2,BOS,9,15,9200,131,6,W
1940-07-03,0,BOS,11,12,2400,140,1,W
1940-07-04,1,BOS,12,4,0,140,-8,NW
1940-07-04,2,BOS,7,3,29000,121,-4,NW
1940-07-11,0,BOS,2,3,3700,155,1,W
1940-07-13,1,BOS,5,0,0,100,-5,NW
1940-07-13,2,BOS,7,0,16700,130,-7,NW
1940-07-14,1,BOS,4,5,0,145,1,W
1940-07-14,2,BOS,3,7,17000,120,4,W
1940-07-15,0,BOS,6,10,2500,133,4,W
1940-07-17,1,BOS,3,8,0,152,5,W
1940-07-17,2,BOS,5,8,32400,120,3,W
1940-07-18,0,BOS,10,8,5800,192,-2,NW
1940-07-19,0,BOS,4,0,6500,119,-4,NW
1940-07-20,0,BOS,9,6,10200,137,-3,NW
1940-07-21,1,BOS,3,2,0,154,-1,NW
1940-07-21,2,BOS,2,0,34600,110,-2,NW
1940-08-05,0,BOS,1,4,5100,141,3,W
1940-08-06,0,BOS,3,8,7600,136,5,W
1940-08-07,1,BOS,7,10,0,164,3,W
1940-08-07,2,BOS,6,3,32500,149,-3,NW
1940-08-08,0,BOS,5,6,8500,125,1,W
1940-08-16,0,BOS,6,7,5500,164,1,W
1940-08-17,0,BOS,9,12,7800,155,3,W
1940-08-18,0,BOS,2,4,15700,106,2,W
1940-08-19,0,BOS,7,16,7830,139,9,W
1940-08-20,0,BOS,11,6,20200,165,-5,NW
1940-08-21,0,BOS,4,2,10600,147,-2,NW
1940-08-22,0,BOS,9,8,6600,152,-1,NW
1940-08-24,1,BOS,12,1,0,132,-11,NW
1940-08-24,2,BOS,7,8,29200,125,1,W
1940-08-25,1,BOS,7,2,0,150,-5,NW
1940-08-25,2,BOS,3,17,18600,116,14,W
1940-08-26,0,BOS,6,7,2400,133,1,W
1940-08-28,0,BOS,3,2,7600,103,-1,NW
1940-08-29,0,BOS,3,4,5400,137,1,W
1940-09-04,1,BOS,5,6,0,153,1,W
1940-09-04,2,BOS,4,5,5600,161,1,W
1940-09-05,0,BOS,7,9,6200,128,2,W
1940-09-07,0,BOS,4,3,19000,112,-1,NW
1940-09-08,0,BOS,9,4,33800,168,-5,NW
1940-09-26,0,BOS,6,5,1100,121,-1,NW
1940-09-27,0,BOS,4,24,2200,139,20,W
1940-09-28,1,BOS,4,16,0,105,12,W
1940-09-28,2,BOS,1,8,3200,97,7,W
1940-09-29,1,BOS,4,9,0,105,5,W
1940-09-29,2,BOS,1,4,6800,95,3,W
1941-04-15,0,BOS,6,7,15000,160,1,W
1941-04-16,0,BOS,7,8,5200,200,1,W
1941-04-25,0,BOS,1,3,2000,106,2,W
1941-04-26,0,BOS,7,8,2600,127,1,W
1941-05-11,0,BOS,5,13,34000,154,8,W
1941-05-12,0,BOS,4,8,10963,195,4,W
1941-05-13,0,BOS,3,2,3000,107,-1,NW
1941-05-14,0,BOS,7,10,3200,138,3,W
1941-05-15,0,BOS,6,4,7500,160,-2,NW
1941-05-16,0,BOS,9,3,6600,143,-6,NW
1941-05-17,0,BOS,12,9,20000,200,-3,NW
1941-05-18,0,BOS,6,5,23000,178,-1,NW
1941-05-19,0,BOS,4,2,3000,132,-2,NW
1941-05-20,0,BOS,2,4,3300,104,2,W
1941-05-21,0,BOS,6,8,3500,140,2,W
1941-05-22,0,BOS,4,1,3400,132,-3,NW
1941-05-27,1,BOS,2,5,0,115,3,W
1941-05-27,2,BOS,11,1,4900,137,-10,NW
1941-05-28,0,BOS,8,6,1400,205,-2,NW
1941-05-29,0,BOS,4,6,1900,122,2,W
1941-05-30,1,BOS,4,3,0,122,-1,NW
1941-05-30,2,BOS,0,13,34500,150,13,W
1941-06-14,0,BOS,5,2,6000,153,-3,NW
1941-06-15,1,BOS,6,8,NA,128,2,W
1941-06-15,2,BOS,4,6,34500,114,2,W
1941-06-17,1,BOS,6,14,0,152,8,W
1941-06-17,2,BOS,8,5,23000,148,-3,NW
1941-06-18,0,BOS,5,2,5400,142,-3,NW
1941-06-19,0,BOS,4,6,4100,141,2,W
1941-06-20,0,BOS,2,4,3100,128,2,W
1941-06-21,0,BOS,13,9,5400,161,-4,NW
1941-06-22,1,BOS,5,7,0,132,2,W
1941-06-22,2,BOS,12,3,20000,130,-9,NW
1941-06-24,0,BOS,2,13,8060,125,11,W
1941-06-25,0,BOS,2,7,11000,123,5,W
1941-06-26,0,BOS,11,8,24000,189,-3,NW
1941-07-05,0,BOS,0,5,8600,115,5,W
1941-07-06,1,BOS,2,6,0,108,4,W
1941-07-06,2,BOS,3,4,25000,92,1,W
1941-07-22,0,BOS,2,6,4100,102,4,W
1941-07-23,0,BOS,10,4,5200,147,-6,NW
1941-07-24,0,BOS,1,11,2600,140,10,W
1941-07-25,0,BOS,6,10,10000,147,4,W
1941-07-26,0,BOS,3,4,15274,160,1,W
1941-07-27,0,BOS,4,0,29264,112,-4,NW
1941-07-29,0,BOS,3,2,4701,143,-1,NW
1941-07-31,1,BOS,16,11,0,191,-5,NW
1941-07-31,2,BOS,1,4,25000,95,3,W
1941-08-02,0,BOS,6,5,9357,133,-1,NW
1941-08-03,0,BOS,6,3,14634,148,-3,NW
1941-08-04,0,BOS,6,7,3260,135,1,W
1941-08-05,0,BOS,5,6,3600,131,1,W
1941-08-06,1,BOS,3,6,0,134,3,W
1941-08-06,2,BOS,3,1,34427,119,-2,NW
1941-08-07,0,BOS,5,9,11593,140,4,W
1941-08-08,0,BOS,8,15,3959,135,7,W
1941-08-09,0,BOS,8,6,5835,150,-2,NW
1941-08-10,1,BOS,6,7,0,140,1,W
1941-08-10,2,BOS,8,2,25858,130,-6,NW
1941-08-30,0,BOS,3,12,6387,113,9,W
1941-08-31,1,BOS,3,5,0,103,2,W
1941-08-31,2,BOS,3,2,22570,111,-1,NW
1941-09-01,1,BOS,9,13,0,167,4,W
1941-09-01,2,BOS,2,10,22577,129,8,W
1941-09-03,0,BOS,2,1,15672,145,-1,NW
1941-09-04,0,BOS,6,3,13088,125,-3,NW
1941-09-09,0,BOS,0,6,3200,109,6,W
1941-09-10,0,BOS,2,11,4931,135,9,W
1941-09-12,0,BOS,0,5,5932,115,5,W
1941-09-13,0,BOS,2,7,6153,126,5,W
1941-09-14,1,BOS,2,9,0,104,7,W
1941-09-14,2,BOS,1,5,36224,105,4,W
1941-09-15,0,BOS,1,6,3897,104,5,W
1941-09-17,0,BOS,2,3,6858,115,1,W
1941-09-18,0,BOS,6,1,8204,138,-5,NW
1941-09-20,0,BOS,8,1,12014,129,-7,NW
1941-09-21,0,BOS,1,4,28070,108,3,W
1942-04-14,0,BOS,3,8,9901,141,5,W
1942-04-15,0,BOS,1,3,2459,105,2,W
1942-04-16,0,BOS,4,19,2891,126,15,W
1942-04-20,0,BOS,10,4,10000,142,-6,NW
1942-04-24,0,BOS,8,5,23256,110,-3,NW
1942-04-25,0,BOS,2,4,19538,125,2,W
1942-04-26,0,BOS,7,2,38010,126,-5,NW
1942-04-28,0,BOS,1,6,4868,110,5,W
1942-04-29,0,BOS,4,2,6040,118,-2,NW
1942-04-30,0,BOS,3,8,5482,118,5,W
1942-05-01,0,BOS,10,6,4609,134,-4,NW
1942-05-02,0,BOS,10,11,10261,140,1,W
1942-05-03,0,BOS,4,8,32123,127,4,W
1942-05-04,0,BOS,8,11,8637,144,3,W
1942-05-05,0,BOS,3,13,10104,133,10,W
1942-05-06,0,BOS,1,3,6550,100,2,W
1942-05-23,0,BOS,4,3,12216,125,-1,NW
1942-05-24,1,BOS,6,5,0,144,-1,NW
1942-05-24,2,BOS,5,6,24284,120,1,W
1942-05-31,1,BOS,1,11,0,131,10,W
1942-05-31,2,BOS,3,4,23906,133,1,W
1942-06-02,0,BOS,7,2,2717,120,-5,NW
1942-06-04,0,BOS,4,2,3593,114,-2,NW
1942-06-05,0,BOS,2,4,3538,110,2,W
1942-06-06,0,BOS,3,1,7316,117,-2,NW
1942-06-07,1,BOS,2,3,0,96,1,W
1942-06-07,2,BOS,2,3,20061,100,1,W
1942-06-09,0,BOS,4,7,4676,117,3,W
1942-06-10,0,BOS,3,10,4806,123,7,W
1942-06-11,0,BOS,7,8,4020,150,1,W
1942-06-13,0,BOS,5,6,6640,150,1,W
1942-06-14,1,BOS,2,3,0,111,1,W
1942-06-14,2,BOS,1,2,30311,142,1,W
1942-06-30,1,BOS,8,9,NA,152,1,W
1942-06-30,2,BOS,2,5,9506,115,3,W
1942-07-01,1,BOS,2,3,0,140,1,W
1942-07-01,2,BOS,1,7,10593,120,6,W
1942-07-03,0,BOS,5,3,21296,118,-2,NW
1942-07-04,1,BOS,6,3,0,153,-3,NW
1942-07-04,2,BOS,4,6,33675,110,2,W
1942-07-09,0,BOS,1,2,7757,125,1,W
1942-07-10,0,BOS,1,6,7506,102,5,W
1942-07-12,1,BOS,1,0,0,117,-1,NW
1942-07-12,2,BOS,10,6,34519,146,-4,NW
1942-07-14,0,BOS,3,2,4247,117,-1,NW
1942-07-15,1,BOS,1,10,0,113,9,W
1942-07-15,2,BOS,11,6,12363,138,-5,NW
1942-07-16,0,BOS,3,2,3795,119,-1,NW
1942-07-17,0,BOS,1,2,3324,115,1,W
1942-07-19,1,BOS,10,7,0,178,-3,NW
1942-07-19,2,BOS,4,0,32025,92,-4,NW
1942-08-04,0,BOS,6,4,4314,114,-2,NW
1942-08-05,0,BOS,0,7,4533,110,7,W
1942-08-06,0,BOS,0,2,4066,106,2,W
1942-08-15,1,BOS,1,2,0,104,1,W
1942-08-15,2,BOS,6,7,9883,137,1,W
1942-08-16,1,BOS,4,6,0,108,2,W
1942-08-16,2,BOS,3,10,19707,137,7,W
1942-08-18,0,BOS,7,8,10277,142,1,W
1942-08-19,1,BOS,4,6,0,119,2,W
1942-08-19,2,BOS,2,1,38814,118,-1,NW
1942-08-20,0,BOS,4,7,16956,122,3,W
1942-08-25,1,BOS,3,4,0,146,1,W
1942-08-25,2,BOS,1,5,15537,119,4,W
1942-08-26,0,BOS,1,4,3908,109,3,W
1942-08-27,0,BOS,4,2,8102,102,-2,NW
1942-08-28,0,BOS,0,4,4539,107,4,W
1942-08-29,0,BOS,2,4,6543,122,2,W
1942-08-30,1,BOS,4,1,0,135,-3,NW
1942-08-30,2,BOS,6,12,37796,128,6,W
1942-08-31,0,BOS,6,8,7153,113,2,W
1942-09-02,1,BOS,2,3,0,99,1,W
1942-09-02,2,BOS,2,4,18598,118,2,W
1942-09-03,0,BOS,0,2,4568,112,2,W
1942-09-05,0,BOS,4,3,7704,124,-1,NW
1942-09-06,0,BOS,7,8,14978,132,1,W
1942-09-27,0,BOS,6,7,20000,92,1,W
1943-04-27,0,BOS,1,5,9120,124,4,W
1943-04-28,0,BOS,5,0,3212,120,-5,NW
1943-04-29,0,BOS,7,3,2483,157,-4,NW
1943-05-01,0,BOS,1,3,1664,115,2,W
1943-05-02,1,BOS,6,7,0,131,1,W
1943-05-02,2,BOS,8,1,17050,121,-7,NW
1943-05-27,1,BOS,0,2,1821,120,2,W
1943-05-27,2,BOS,3,4,1957,79,1,W
1943-05-28,0,BOS,5,2,3000,122,-3,NW
1943-05-29,0,BOS,6,4,3359,112,-2,NW
1943-05-30,1,BOS,0,3,0,92,3,W
1943-05-30,2,BOS,1,5,17640,99,4,W
1943-05-31,1,BOS,1,2,0,113,1,W
1943-05-31,2,BOS,6,7,15658,137,1,W
1943-06-02,1,BOS,7,4,0,155,-3,NW
1943-06-02,2,BOS,2,3,3363,102,1,W
1943-06-03,0,BOS,6,4,2039,137,-2,NW
1943-06-04,0,BOS,4,3,1643,115,-1,NW
1943-06-05,0,BOS,4,1,3256,100,-3,NW
1943-06-06,1,BOS,3,4,0,115,1,W
1943-06-06,2,BOS,2,3,16937,143,1,W
1943-06-09,0,BOS,2,3,2938,102,1,W
1943-06-10,0,BOS,0,2,2493,105,2,W
1943-06-12,0,BOS,1,0,4135,101,-1,NW
1943-06-13,1,BOS,16,5,0,150,-11,NW
1943-06-13,2,BOS,0,7,18928,115,7,W
1943-06-15,1,BOS,7,4,0,126,-3,NW
1943-06-15,2,BOS,4,2,4264,116,-2,NW
1943-06-16,0,BOS,2,3,1545,112,1,W
1943-06-17,1,BOS,4,5,0,92,1,W
1943-06-17,2,BOS,8,7,7705,142,-1,NW
1943-06-25,0,BOS,2,2,6206,141,0,NW
1943-06-26,0,BOS,1,4,6797,126,3,W
1943-06-27,1,BOS,3,2,0,127,-1,NW
1943-06-27,2,BOS,3,4,33617,163,1,W
1943-07-21,1,BOS,2,3,0,105,1,W
1943-07-21,2,BOS,8,6,7437,121,-2,NW
1943-07-23,1,BOS,7,8,0,151,1,W
1943-07-23,2,BOS,5,1,2617,147,-4,NW
1943-07-24,0,BOS,3,5,3623,114,2,W
1943-07-25,1,BOS,0,7,0,99,7,W
1943-07-25,2,BOS,4,6,16860,115,2,W
1943-07-26,0,BOS,7,1,1500,116,-6,NW
1943-07-28,1,BOS,1,4,0,101,3,W
1943-07-28,2,BOS,4,6,18032,119,2,W
1943-07-30,1,BOS,2,4,0,115,2,W
1943-07-30,2,BOS,5,2,3348,119,-3,NW
1943-07-31,0,BOS,4,5,3658,184,1,W
1943-08-01,1,BOS,8,6,0,165,-2,NW
1943-08-01,2,BOS,1,4,21092,127,3,W
1943-08-03,0,BOS,11,9,3757,123,-2,NW
1943-08-06,0,BOS,4,2,4102,112,-2,NW
1943-08-07,0,BOS,5,7,4483,136,2,W
1943-08-08,1,BOS,4,3,0,119,-1,NW
1943-08-08,2,BOS,3,4,19218,114,1,W
1943-09-03,0,BOS,5,4,1930,121,-1,NW
1943-09-04,0,BOS,1,2,1414,78,1,W
1943-09-05,0,BOS,7,5,6468,125,-2,NW
1943-09-06,1,BOS,1,5,0,103,4,W
1943-09-06,2,BOS,1,4,14959,102,3,W
1943-09-09,0,BOS,11,3,5955,144,-8,NW
1943-09-10,0,BOS,9,3,4853,110,-6,NW
1943-09-11,0,BOS,4,0,4996,125,-4,NW
1943-09-12,1,BOS,1,0,0,106,-1,NW
1943-09-12,2,BOS,9,6,28778,130,-3,NW
1943-09-23,1,BOS,7,13,0,123,6,W
1943-09-23,2,BOS,6,4,2456,145,-2,NW
1943-09-24,0,BOS,0,1,822,103,1,W
1943-09-25,0,BOS,6,3,1657,128,-3,NW
1943-09-26,1,BOS,2,3,0,123,1,W
1943-09-26,2,BOS,2,6,6455,107,4,W
1943-09-27,0,BOS,6,3,714,95,-3,NW
1943-09-28,0,BOS,1,6,1000,113,5,W
1943-09-29,1,BOS,4,3,0,150,-1,NW
1943-09-29,2,BOS,3,3,8000,120,0,NW
1943-10-03,1,BOS,4,2,0,88,-2,NW
1943-10-03,2,BOS,3,1,3923,92,-2,NW
1944-04-18,0,BOS,3,0,9973,112,-3,NW
1944-04-19,1,BOS,1,6,3376,118,5,W
1944-04-19,2,BOS,2,5,13650,106,3,W
1944-04-28,0,BOS,7,5,2000,211,-2,NW
1944-04-29,0,BOS,0,7,3954,116,7,W
1944-04-30,1,BOS,2,3,0,100,1,W
1944-04-30,2,BOS,3,1,22357,122,-2,NW
1944-05-01,0,BOS,11,4,1596,129,-7,NW
1944-05-02,0,BOS,5,2,1521,109,-3,NW
1944-05-03,0,BOS,10,11,2600,137,1,W
1944-05-10,0,BOS,5,4,3695,135,-1,NW
1944-05-11,0,BOS,7,6,2580,152,-1,NW
1944-05-12,0,BOS,3,10,2132,135,7,W
1944-05-13,0,BOS,2,4,4786,118,2,W
1944-05-14,1,BOS,6,1,0,105,-5,NW
1944-05-14,2,BOS,9,0,20317,118,-9,NW
1944-05-16,0,BOS,7,3,1674,159,-4,NW
1944-05-17,1,BOS,1,5,0,120,4,W
1944-05-17,2,BOS,12,8,5072,140,-4,NW
1944-05-18,0,BOS,1,12,1913,123,11,W
1944-05-19,0,BOS,2,3,1228,158,1,W
1944-05-20,0,BOS,1,8,3777,105,7,W
1944-05-21,1,BOS,3,4,0,105,1,W
1944-05-21,2,BOS,2,9,21330,112,7,W
1944-06-07,0,BOS,1,8,4237,115,7,W
1944-06-08,0,BOS,7,8,7984,125,1,W
1944-06-11,1,BOS,1,2,0,122,1,W
1944-06-11,2,BOS,1,4,23657,100,3,W
1944-06-13,0,BOS,2,7,4428,105,5,W
1944-06-14,1,BOS,4,6,0,105,2,W
1944-06-14,2,BOS,0,5,6039,112,5,W
1944-06-15,0,BOS,1,5,770,86,4,W
1944-06-23,0,BOS,7,1,2607,117,-6,NW
1944-06-25,1,BOS,5,4,0,143,-1,NW
1944-06-25,2,BOS,0,4,6230,97,4,W
1944-06-28,0,BOS,3,4,4961,134,1,W
1944-06-29,0,BOS,4,5,2812,115,1,W
1944-06-30,0,BOS,0,11,3475,118,11,W
1944-07-01,0,BOS,9,1,6254,122,-8,NW
1944-07-02,1,BOS,0,1,0,107,1,W
1944-07-02,2,BOS,3,4,32436,156,1,W
1944-07-04,1,BOS,4,3,0,122,-1,NW
1944-07-04,2,BOS,4,7,24195,110,3,W
1944-07-05,0,BOS,8,1,5126,120,-7,NW
1944-07-06,0,BOS,3,13,5146,116,10,W
1944-07-07,0,BOS,8,5,4541,132,-3,NW
1944-07-08,0,BOS,7,11,4230,129,4,W
1944-07-09,1,BOS,8,2,NA,136,-6,NW
1944-07-09,2,BOS,2,4,22492,104,2,W
1944-08-04,1,BOS,7,5,0,130,-2,NW
1944-08-04,2,BOS,0,4,10320,120,4,W
1944-08-05,0,BOS,2,6,3371,125,4,W
1944-08-06,1,BOS,3,2,0,88,-1,NW
1944-08-06,2,BOS,4,5,19654,141,1,W
1944-08-09,0,BOS,1,9,11215,106,8,W
1944-08-10,0,BOS,1,2,3362,98,1,W
1944-08-11,0,BOS,9,7,2578,140,-2,NW
1944-08-12,0,BOS,4,5,3103,128,1,W
1944-08-13,1,BOS,6,7,0,195,1,W
1944-08-13,2,BOS,6,1,31844,77,-5,NW
1944-08-14,0,BOS,1,5,5323,115,4,W
1944-08-15,0,BOS,6,5,8716,124,-1,NW
1944-08-16,0,BOS,4,2,3452,123,-2,NW
1944-08-17,0,BOS,3,3,2000,88,0,NW
1944-08-18,1,BOS,3,0,0,116,-3,NW
1944-08-18,2,BOS,4,7,2432,114,3,W
1944-08-19,0,BOS,1,9,5140,99,8,W
1944-08-20,1,BOS,6,8,0,136,2,W
1944-08-20,2,BOS,4,11,25310,116,7,W
1944-08-21,0,BOS,7,6,4038,171,-1,NW
1944-08-22,0,BOS,5,3,4967,133,-2,NW
1944-09-01,0,BOS,3,4,4502,99,1,W
1944-09-02,0,BOS,5,6,6396,138,1,W
1944-09-03,0,BOS,5,1,22689,119,-4,NW
1944-09-08,0,BOS,7,6,13079,172,-1,NW
1944-09-09,0,BOS,1,7,12294,115,6,W
1944-09-10,1,BOS,2,3,0,104,1,W
1944-09-10,2,BOS,4,3,34182,109,-1,NW
1945-04-20,0,BOS,5,3,3489,123,-2,NW
1945-04-21,0,BOS,8,2,5241,138,-6,NW
1945-04-22,0,BOS,6,1,5064,134,-5,NW
1945-05-01,0,BOS,4,5,1919,112,1,W
1945-05-02,0,BOS,0,4,2808,109,4,W
1945-05-05,0,BOS,7,3,7662,131,-4,NW
1945-05-06,1,BOS,0,5,0,120,5,W
1945-05-06,2,BOS,2,0,32073,129,-2,NW
1945-05-23,0,BOS,1,4,9270,101,3,W
1945-05-24,0,BOS,6,8,3241,139,2,W
1945-05-25,0,BOS,5,0,3305,117,-5,NW
1945-05-26,0,BOS,9,2,7388,141,-7,NW
1945-05-27,1,BOS,0,7,0,104,7,W
1945-05-27,2,BOS,1,2,24547,90,1,W
1945-05-28,0,BOS,8,6,1177,122,-2,NW
1945-05-29,0,BOS,4,6,2409,128,2,W
1945-05-30,1,BOS,4,3,0,143,-1,NW
1945-05-30,2,BOS,6,7,18356,120,1,W
1945-05-31,0,BOS,2,6,4306,122,4,W
1945-06-01,0,BOS,4,6,1861,120,2,W
1945-06-02,0,BOS,1,5,4352,104,4,W
1945-06-03,1,BOS,3,4,0,116,1,W
1945-06-03,2,BOS,4,3,15522,112,-1,NW
1945-06-06,1,BOS,2,5,0,119,3,W
1945-06-06,2,BOS,2,3,9389,113,1,W
1945-06-07,0,BOS,4,5,2208,138,1,W
1945-06-19,0,BOS,0,1,12098,113,1,W
1945-06-21,0,BOS,14,4,15110,138,-10,NW
1945-06-22,0,BOS,5,10,2863,115,5,W
1945-06-23,0,BOS,6,5,5582,140,-1,NW
1945-06-24,1,BOS,5,6,0,109,1,W
1945-06-24,2,BOS,5,2,32725,132,-3,NW
1945-07-12,0,BOS,1,2,9006,116,1,W
1945-07-13,0,BOS,1,5,9522,110,4,W
1945-07-14,0,BOS,1,7,7379,125,6,W
1945-07-15,0,BOS,4,6,27345,90,2,W
1945-07-16,0,BOS,3,2,8917,130,-1,NW
1945-07-17,0,BOS,6,1,4323,125,-5,NW
1945-07-18,0,BOS,2,6,10151,107,4,W
1945-07-19,0,BOS,5,3,4505,125,-2,NW
1945-07-20,0,BOS,6,3,4284,115,-3,NW
1945-07-21,0,BOS,4,1,7253,130,-3,NW
1945-07-22,1,BOS,2,3,0,127,1,W
1945-07-22,2,BOS,5,1,33698,115,-4,NW
1945-07-24,0,BOS,0,6,6051,116,6,W
1945-07-27,0,BOS,3,1,22000,118,-2,NW
1945-07-28,0,BOS,2,6,6993,120,4,W
1945-07-29,0,BOS,4,8,10183,125,4,W
1945-07-31,0,BOS,4,2,22477,140,-2,NW
1945-08-01,0,BOS,5,7,10426,120,2,W
1945-08-02,0,BOS,3,1,10119,120,-2,NW
1945-08-26,1,BOS,3,4,0,142,1,W
1945-08-26,2,BOS,3,4,22364,108,1,W
1945-09-03,1,BOS,11,5,0,140,-6,NW
1945-09-03,2,BOS,4,8,28804,115,4,W
1945-09-05,1,BOS,1,2,0,104,1,W
1945-09-05,2,BOS,5,2,9899,140,-3,NW
1945-09-06,0,BOS,3,9,2598,120,6,W
1945-09-07,0,BOS,0,1,2715,92,1,W
1945-09-08,0,BOS,4,9,6136,110,5,W
1945-09-09,1,BOS,6,3,0,122,-3,NW
1945-09-09,2,BOS,3,3,28898,139,0,NW
1945-09-10,1,BOS,2,9,0,117,7,W
1945-09-10,2,BOS,2,1,5847,100,-1,NW
1945-09-11,0,BOS,5,0,3497,94,-5,NW
1945-09-12,0,BOS,9,2,3357,106,-7,NW
1945-09-13,0,BOS,2,1,3507,95,-1,NW
1945-09-14,0,BOS,4,1,1729,100,-3,NW
1945-09-16,1,BOS,5,3,0,93,-2,NW
1945-09-16,2,BOS,6,1,15337,103,-5,NW
1945-09-17,1,BOS,4,8,0,102,4,W
1945-09-17,2,BOS,4,2,1646,88,-2,NW
1945-09-19,1,BOS,10,11,0,125,1,W
1945-09-19,2,BOS,0,3,2026,104,3,W
1945-09-20,0,BOS,0,2,1007,86,2,W
1945-09-22,0,BOS,2,1,5111,107,-1,NW
1945-09-23,1,BOS,5,6,0,202,1,W
1945-09-23,2,BOS,2,1,30010,62,-1,NW
1946-04-20,0,BOS,1,2,30446,94,1,W
1946-04-21,1,BOS,11,12,0,188,1,W
1946-04-21,2,BOS,3,0,32916,82,-3,NW
1946-04-22,0,BOS,4,5,7315,99,1,W
1946-04-23,0,BOS,8,2,12682,188,-6,NW
1946-04-24,0,BOS,12,5,30028,148,-7,NW
1946-04-25,0,BOS,5,12,31150,145,7,W
1946-04-30,0,BOS,0,4,18877,115,4,W
1946-05-01,0,BOS,1,13,27371,132,12,W
1946-05-02,0,BOS,4,5,21543,120,1,W
1946-05-03,0,BOS,4,9,10360,125,5,W
1946-05-04,0,BOS,2,6,30713,137,4,W
1946-05-06,1,BOS,5,7,0,122,2,W
1946-05-06,2,BOS,4,5,25988,119,1,W
1946-05-07,0,BOS,6,10,11399,197,4,W
1946-05-08,0,BOS,10,14,11930,157,4,W
1946-05-09,0,BOS,5,7,21481,115,2,W
1946-05-25,0,BOS,4,7,30851,142,3,W
1946-05-26,1,BOS,0,1,0,106,1,W
1946-05-26,2,BOS,4,1,32852,108,-3,NW
1946-05-29,0,BOS,0,2,5287,114,2,W
1946-05-30,1,BOS,5,6,0,140,1,W
1946-05-30,2,BOS,2,7,33505,106,5,W
1946-06-03,1,BOS,1,6,0,108,5,W
1946-06-03,2,BOS,2,5,27631,115,3,W
1946-06-04,0,BOS,4,9,7671,135,5,W
1946-06-05,0,BOS,8,8,10672,209,0,NW
1946-06-06,0,BOS,4,5,19151,139,1,W
1946-06-08,0,BOS,4,15,29453,135,11,W
1946-06-09,1,BOS,1,7,0,126,6,W
1946-06-09,2,BOS,6,11,32800,127,5,W
1946-06-10,0,BOS,3,6,16988,120,3,W
1946-06-11,0,BOS,5,10,17046,150,5,W
1946-06-12,0,BOS,7,2,33534,145,-5,NW
1946-06-28,0,BOS,1,12,17639,130,11,W
1946-06-29,0,BOS,8,12,18927,145,4,W
1946-06-30,1,BOS,8,15,0,165,7,W
1946-06-30,2,BOS,9,2,29207,138,-7,NW
1946-07-11,0,BOS,2,3,26795,127,1,W
1946-07-12,0,BOS,2,4,26290,115,2,W
1946-07-13,0,BOS,4,5,26102,134,1,W
1946-07-14,1,BOS,10,11,0,152,1,W
1946-07-14,2,BOS,4,6,31581,132,2,W
1946-07-16,0,BOS,6,3,33142,130,-3,NW
1946-07-17,1,BOS,1,3,0,105,2,W
1946-07-17,2,BOS,1,6,29234,114,5,W
1946-07-18,0,BOS,2,3,12605,109,1,W
1946-07-19,0,BOS,2,9,11222,125,7,W
1946-07-20,0,BOS,5,4,22934,132,-1,NW
1946-07-21,1,BOS,0,5,0,120,5,W
1946-07-21,2,BOS,4,7,32358,143,3,W
1946-08-06,0,BOS,0,5,17152,95,5,W
1946-08-08,1,BOS,3,4,0,118,1,W
1946-08-08,2,BOS,6,10,31689,135,4,W
1946-08-16,0,BOS,1,4,29226,115,3,W
1946-08-17,0,BOS,4,7,30570,118,3,W
1946-08-18,1,BOS,5,0,0,107,-5,NW
1946-08-18,2,BOS,3,4,33437,132,1,W
1946-08-20,1,BOS,1,5,0,98,4,W
1946-08-20,2,BOS,5,4,29224,132,-1,NW
1946-08-21,0,BOS,9,12,18241,144,3,W
1946-08-22,0,BOS,4,3,12198,142,-1,NW
1946-08-24,1,BOS,5,6,0,113,1,W
1946-08-24,2,BOS,3,1,31696,105,-2,NW
1946-08-25,1,BOS,1,2,0,98,1,W
1946-08-25,2,BOS,6,13,32794,135,7,W
1946-08-26,0,BOS,1,5,20925,110,4,W
1946-08-28,0,BOS,7,2,28789,131,-5,NW
1946-08-29,0,BOS,9,8,22249,200,-1,NW
1946-08-30,1,BOS,0,6,0,101,6,W
1946-08-30,2,BOS,2,6,16833,118,4,W
1946-08-31,0,BOS,2,4,16503,110,2,W
1946-09-01,0,BOS,3,4,28372,136,1,W
1946-09-24,0,BOS,4,5,14210,126,1,W
1946-09-25,0,BOS,2,5,13602,114,3,W
1946-09-27,0,BOS,4,5,9004,122,1,W
1946-09-28,0,BOS,4,3,13936,131,-1,NW
1946-09-29,0,BOS,7,0,21815,125,-7,NW
1947-04-15,0,BOS,6,7,30822,142,1,W
1947-04-17,0,BOS,1,4,12779,125,3,W
1947-04-25,0,BOS,11,7,7362,142,-4,NW
1947-04-26,0,BOS,5,2,14418,130,-3,NW
1947-04-27,0,BOS,6,6,34693,150,0,NW
1947-05-10,0,BOS,9,6,34083,158,-3,NW
1947-05-11,0,BOS,7,8,32211,162,1,W
1947-05-12,0,BOS,3,4,24726,137,1,W
1947-05-13,0,BOS,6,19,9729,153,13,W
1947-05-14,0,BOS,1,5,4546,130,4,W
1947-05-15,0,BOS,2,1,11140,122,-1,NW
1947-05-16,0,BOS,7,12,8639,148,5,W
1947-05-17,0,BOS,4,2,24019,123,-2,NW
1947-05-19,1,BOS,3,2,0,160,-1,NW
1947-05-19,2,BOS,4,5,28280,114,1,W
1947-05-20,0,BOS,3,8,10305,133,5,W
1947-06-13,0,BOS,3,5,34510,155,2,W
1947-06-15,1,BOS,3,7,0,115,4,W
1947-06-15,2,BOS,4,8,34024,136,4,W
1947-06-17,0,BOS,5,6,22626,134,1,W
1947-06-18,0,BOS,5,6,34462,260,1,W
1947-06-20,0,BOS,3,2,34167,110,-1,NW
1947-06-21,0,BOS,1,9,31244,145,8,W
1947-06-22,1,BOS,8,2,0,130,-6,NW
1947-06-22,2,BOS,3,6,34863,146,3,W
1947-06-23,0,BOS,2,8,20652,118,6,W
1947-06-25,1,BOS,4,2,0,125,-2,NW
1947-06-25,2,BOS,3,4,22356,101,1,W
1947-06-30,0,BOS,3,1,34705,135,-2,NW
1947-07-02,0,BOS,7,6,32809,143,-1,NW
1947-07-03,0,BOS,8,4,16969,145,-4,NW
1947-07-04,1,BOS,8,6,0,184,-2,NW
1947-07-04,2,BOS,0,4,29181,108,4,W
1947-07-05,0,BOS,6,7,17050,177,1,W
1947-07-06,1,BOS,4,7,0,164,3,W
1947-07-06,2,BOS,1,10,29309,103,9,W
1947-07-22,0,BOS,2,3,6670,148,1,W
1947-07-23,0,BOS,7,8,31479,205,1,W
1947-07-24,0,BOS,2,8,9093,125,6,W
1947-07-25,0,BOS,6,7,34059,123,1,W
1947-07-26,0,BOS,1,12,12256,122,11,W
1947-07-27,1,BOS,3,4,0,113,1,W
1947-07-27,2,BOS,2,11,33332,138,9,W
1947-07-29,0,BOS,5,1,30957,163,-4,NW
1947-07-30,0,BOS,13,7,34663,140,-6,NW
1947-07-31,0,BOS,5,4,5879,127,-1,NW
1947-08-01,0,BOS,3,1,32286,130,-2,NW
1947-08-02,0,BOS,1,2,32794,108,1,W
1947-08-03,0,BOS,10,3,24565,159,-7,NW
1947-08-08,0,BOS,6,9,34711,143,3,W
1947-08-09,0,BOS,4,6,23723,132,2,W
1947-08-10,0,BOS,2,1,31329,151,-1,NW
1947-08-11,0,BOS,0,1,24043,104,1,W
1947-08-12,0,BOS,1,2,13934,119,1,W
1947-08-13,0,BOS,3,10,34451,135,7,W
1947-08-29,0,BOS,1,2,34683,105,1,W
1947-08-30,0,BOS,0,2,13818,109,2,W
1947-08-31,0,BOS,1,5,22944,120,4,W
1947-09-01,1,BOS,3,6,0,156,3,W
1947-09-01,2,BOS,1,4,35294,105,3,W
1947-09-03,1,BOS,11,2,0,140,-9,NW
1947-09-03,2,BOS,9,6,32723,161,-3,NW
1947-09-09,0,BOS,3,5,8795,123,2,W
1947-09-10,0,BOS,5,0,9253,107,-5,NW
1947-09-11,1,BOS,10,8,0,161,-2,NW
1947-09-11,2,BOS,3,8,10135,113,5,W
1947-09-12,0,BOS,11,6,4855,167,-5,NW
1947-09-13,0,BOS,2,3,15908,105,1,W
1947-09-14,0,BOS,1,1,22080,108,0,NW
1947-09-15,1,BOS,6,3,NA,141,-3,NW
1947-09-15,2,BOS,5,7,6246,126,2,W
1947-09-16,1,BOS,0,5,NA,100,5,W
1947-09-16,2,BOS,8,3,5062,145,-5,NW
1947-09-17,1,BOS,9,4,0,122,-5,NW
1947-09-17,2,BOS,0,4,7046,113,4,W
1947-09-18,0,BOS,6,10,3592,138,4,W
1947-09-20,1,BOS,6,3,0,129,-3,NW
1947-09-20,2,BOS,2,7,11168,124,5,W
1947-09-21,0,BOS,3,0,12198,126,-3,NW
1947-09-23,1,BOS,9,3,0,140,-6,NW
1947-09-23,2,BOS,5,6,4358,110,1,W
1948-04-19,1,BOS,5,4,22409,171,-1,NW
1948-04-19,2,BOS,4,2,33675,125,-2,NW
1948-04-22,0,BOS,5,3,14241,120,-2,NW
1948-04-30,0,BOS,6,0,20716,113,-6,NW
1948-05-01,0,BOS,6,8,32720,150,2,W
1948-05-02,0,BOS,1,7,34095,137,6,W
1948-05-04,0,BOS,3,6,17316,135,3,W
1948-05-05,0,BOS,3,4,11434,156,1,W
1948-05-06,0,BOS,8,3,15960,146,-5,NW
1948-05-08,0,BOS,9,4,11662,132,-5,NW
1948-05-09,1,BOS,4,1,0,163,-3,NW
1948-05-09,2,BOS,9,5,34298,148,-4,NW
1948-05-10,0,BOS,12,7,11101,162,-5,NW
1948-05-11,0,BOS,0,8,6480,141,8,W
1948-05-12,0,BOS,5,6,8267,152,1,W
1948-05-15,0,BOS,0,5,12834,113,5,W
1948-05-16,0,BOS,5,14,33042,151,9,W
1948-06-02,0,BOS,3,1,25710,138,-2,NW
1948-06-03,0,BOS,2,3,7916,119,1,W
1948-06-04,1,BOS,4,10,0,115,6,W
1948-06-04,2,BOS,2,7,14901,112,5,W
1948-06-06,1,BOS,4,5,0,145,1,W
1948-06-06,2,BOS,4,12,34251,137,8,W
1948-06-08,0,BOS,2,0,33032,121,-2,NW
1948-06-10,0,BOS,7,15,17810,158,8,W
1948-06-11,0,BOS,4,12,33420,146,8,W
1948-06-12,0,BOS,5,3,12259,132,-2,NW
1948-07-02,0,BOS,4,2,33989,137,-2,NW
1948-07-03,0,BOS,8,2,15435,142,-6,NW
1948-07-04,0,BOS,5,19,24363,155,14,W
1948-07-05,1,BOS,5,6,0,145,1,W
1948-07-05,2,BOS,7,8,34138,152,1,W
1948-07-06,0,BOS,1,2,31735,122,1,W
1948-07-07,0,BOS,7,6,33957,141,-1,NW
1948-07-08,0,BOS,1,4,26996,107,3,W
1948-07-15,1,BOS,5,13,14403,146,8,W
1948-07-15,2,BOS,1,3,33892,82,2,W
1948-07-16,0,BOS,3,5,12476,117,2,W
1948-07-17,0,BOS,3,1,17477,117,-2,NW
1948-07-18,1,BOS,5,12,0,145,7,W
1948-07-18,2,BOS,6,7,28563,122,1,W
1948-07-19,0,BOS,1,4,26092,92,3,W
1948-07-20,0,BOS,3,8,9656,135,5,W
1948-07-21,1,BOS,1,3,7148,117,2,W
1948-07-21,2,BOS,9,10,29851,160,1,W
1948-07-22,1,BOS,0,3,0,108,3,W
1948-07-22,2,BOS,3,5,18250,118,2,W
1948-07-23,0,BOS,1,13,6664,128,12,W
1948-07-24,1,BOS,5,6,0,147,1,W
1948-07-24,2,BOS,1,2,34129,110,1,W
1948-07-25,0,BOS,0,3,32190,110,3,W
1948-08-18,0,BOS,2,10,24178,126,8,W
1948-08-19,0,BOS,10,3,18846,154,-7,NW
1948-08-20,1,BOS,4,5,0,134,1,W
1948-08-20,2,BOS,4,10,15865,138,6,W
1948-08-21,0,BOS,6,10,16828,155,4,W
1948-08-22,0,BOS,1,4,26734,116,3,W
1948-08-24,0,BOS,8,9,34172,146,1,W
1948-08-25,0,BOS,9,0,30745,132,-9,NW
1948-08-26,0,BOS,4,8,20322,140,4,W
1948-08-27,0,BOS,5,10,6285,155,5,W
1948-08-28,0,BOS,2,6,10380,130,4,W
1948-08-29,1,BOS,2,10,0,114,8,W
1948-08-29,2,BOS,12,4,27522,140,-8,NW
1948-08-31,0,BOS,4,8,33310,138,4,W
1948-09-01,0,BOS,1,10,22374,139,9,W
1948-09-08,0,BOS,6,10,33775,144,4,W
1948-09-09,0,BOS,4,9,28002,140,5,W
1948-09-10,0,BOS,11,6,27329,200,-5,NW
1948-09-11,1,BOS,1,9,21415,134,8,W
1948-09-11,2,BOS,1,2,34002,115,1,W
1948-09-12,0,BOS,10,4,29100,145,-6,NW
1948-09-28,0,BOS,4,2,10485,137,-2,NW
1948-09-29,0,BOS,1,5,7247,137,4,W
1948-09-30,0,BOS,3,7,4998,121,4,W
1948-10-02,0,BOS,1,5,32118,132,4,W
1948-10-03,0,BOS,5,10,31304,160,5,W
1948-10-04,0,BOS,8,3,33957,144,-5,NW
1949-04-22,0,BOS,5,3,33955,178,-2,NW
1949-04-23,0,BOS,8,11,31367,161,3,W
1949-04-24,0,BOS,9,4,34678,160,-5,NW
1949-04-25,0,BOS,0,2,5341,107,2,W
1949-04-27,0,BOS,6,10,12677,149,4,W
1949-04-28,0,BOS,5,12,10823,145,7,W
1949-05-17,0,BOS,3,4,10309,105,1,W
1949-05-18,0,BOS,4,7,10406,145,3,W
1949-05-19,0,BOS,7,6,8003,158,-1,NW
1949-05-21,0,BOS,0,4,35961,120,4,W
1949-05-22,0,BOS,2,3,31687,170,1,W
1949-05-23,0,BOS,0,4,11853,113,4,W
1949-05-24,0,BOS,7,8,12813,158,1,W
1949-05-25,0,BOS,8,4,7304,150,-4,NW
1949-05-26,0,BOS,5,7,7539,145,2,W
1949-05-28,0,BOS,4,5,13389,141,1,W
1949-05-29,0,BOS,10,4,26806,164,-6,NW
1949-05-30,1,BOS,2,10,0,128,8,W
1949-05-30,2,BOS,3,4,36133,116,1,W
1949-06-14,0,BOS,10,5,35137,153,-5,NW
1949-06-15,0,BOS,8,5,15255,140,-3,NW
1949-06-16,0,BOS,6,3,11666,120,-3,NW
1949-06-17,1,BOS,3,4,7264,168,1,W
1949-06-17,2,BOS,8,10,31446,171,2,W
1949-06-18,0,BOS,5,7,10578,155,2,W
1949-06-19,0,BOS,2,9,20358,132,7,W
1949-06-20,0,BOS,1,6,33710,142,5,W
1949-06-21,0,BOS,1,7,10132,119,6,W
1949-06-22,0,BOS,13,4,9292,146,-9,NW
1949-06-23,0,BOS,0,7,29080,113,7,W
1949-06-24,0,BOS,2,21,6722,140,19,W
1949-06-25,0,BOS,2,13,8953,117,11,W
1949-06-26,0,BOS,3,5,16629,122,2,W
1949-06-28,0,BOS,5,4,36228,148,-1,NW
1949-06-29,0,BOS,9,7,29563,185,-2,NW
1949-06-30,0,BOS,6,3,25237,156,-3,NW
1949-07-08,0,BOS,1,7,34276,128,6,W
1949-07-09,0,BOS,5,7,18191,145,2,W
1949-07-10,1,BOS,5,8,0,116,3,W
1949-07-10,2,BOS,10,11,32108,136,1,W
1949-07-26,0,BOS,2,11,31821,140,9,W
1949-07-27,0,BOS,0,6,9282,112,6,W
1949-07-28,0,BOS,1,6,5651,126,5,W
1949-07-29,1,BOS,1,2,14406,120,1,W
1949-07-29,2,BOS,9,3,34234,140,-6,NW
1949-07-30,0,BOS,10,6,21441,136,-4,NW
1949-07-31,0,BOS,0,3,28802,128,3,W
1949-08-01,0,BOS,3,4,35248,122,1,W
1949-08-02,0,BOS,3,4,27751,128,1,W
1949-08-03,0,BOS,3,9,7833,135,6,W
1949-08-04,0,BOS,2,12,5582,133,10,W
1949-08-05,0,BOS,0,9,35975,128,9,W
1949-08-06,0,BOS,0,3,22826,114,3,W
1949-08-07,0,BOS,6,4,30573,133,-2,NW
1949-08-09,0,BOS,3,6,35091,144,3,W
1949-08-10,0,BOS,3,2,32237,130,-1,NW
1949-08-11,0,BOS,6,7,30818,177,1,W
1949-08-12,1,BOS,7,15,4014,145,8,W
1949-08-12,2,BOS,11,13,32359,194,2,W
1949-08-13,0,BOS,1,5,8847,190,4,W
1949-08-14,1,BOS,3,9,0,145,6,W
1949-08-14,2,BOS,4,13,35985,160,9,W
1949-08-15,0,BOS,2,3,30619,142,1,W
1949-09-02,0,BOS,4,8,33807,151,4,W
1949-09-03,0,BOS,3,10,21269,151,7,W
1949-09-04,0,BOS,2,4,29793,124,2,W
1949-09-05,1,BOS,2,5,0,125,3,W
1949-09-05,2,BOS,2,12,35808,137,10,W
1949-09-13,0,BOS,4,7,10229,141,3,W
1949-09-14,0,BOS,0,1,13196,114,1,W
1949-09-16,0,BOS,4,12,8601,132,8,W
1949-09-17,0,BOS,2,3,17467,137,1,W
1949-09-18,0,BOS,5,11,26390,138,6,W
1949-09-20,0,BOS,2,5,22179,123,3,W
1949-09-21,0,BOS,6,9,22917,159,3,W
1949-09-24,0,BOS,0,3,34515,138,3,W
1949-09-25,0,BOS,1,4,35517,134,3,W
1950-04-18,0,BOS,15,10,31822,208,-5,NW
1950-04-19,1,BOS,3,6,25425,150,3,W
1950-04-19,2,BOS,16,7,32860,190,-9,NW
1950-04-28,0,BOS,1,4,5333,116,3,W
1950-04-30,1,BOS,0,19,0,131,19,W
1950-04-30,2,BOS,5,6,34697,140,1,W
1950-05-02,0,BOS,1,6,11591,148,5,W
1950-05-03,0,BOS,2,7,14582,143,5,W
1950-05-04,0,BOS,5,4,13138,132,-1,NW
1950-05-05,0,BOS,2,5,3415,140,3,W
1950-05-06,0,BOS,1,11,12776,134,10,W
1950-05-07,1,BOS,6,8,0,180,2,W
1950-05-07,2,BOS,2,6,34523,134,4,W
1950-05-09,0,BOS,1,6,15291,131,5,W
1950-05-11,1,BOS,13,4,0,142,-9,NW
1950-05-11,2,BOS,5,3,27758,138,-2,NW
1950-05-12,0,BOS,1,3,5822,110,2,W
1950-05-13,0,BOS,4,5,15724,130,1,W
1950-05-14,1,BOS,1,8,0,129,7,W
1950-05-14,2,BOS,10,5,31148,154,-5,NW
1950-06-02,0,BOS,5,11,35473,146,6,W
1950-06-03,0,BOS,9,11,23612,155,2,W
1950-06-04,0,BOS,7,17,21251,183,10,W
1950-06-05,0,BOS,0,12,29372,165,12,W
1950-06-06,0,BOS,8,4,12755,140,-4,NW
1950-06-07,0,BOS,4,20,6659,148,16,W
1950-06-08,0,BOS,4,29,5105,162,25,W
1950-06-09,0,BOS,12,7,4756,165,-5,NW
1950-06-10,0,BOS,18,8,25851,160,-10,NW
1950-06-11,1,BOS,6,2,0,140,-4,NW
1950-06-11,2,BOS,9,6,34906,193,-3,NW
1950-06-30,1,BOS,9,6,16970,168,-3,NW
1950-06-30,2,BOS,2,10,32539,164,8,W
1950-07-01,0,BOS,4,13,31081,178,9,W
1950-07-02,0,BOS,15,9,32858,196,-6,NW
1950-07-05,0,BOS,9,7,32695,155,-2,NW
1950-07-13,0,BOS,7,8,23751,150,1,W
1950-07-14,0,BOS,1,13,8730,130,12,W
1950-07-15,0,BOS,7,3,11069,132,-4,NW
1950-07-16,1,BOS,10,13,0,178,3,W
1950-07-16,2,BOS,8,4,33009,134,-4,NW
1950-07-17,1,BOS,11,6,12438,154,-5,NW
1950-07-17,2,BOS,5,7,24966,165,2,W
1950-07-18,0,BOS,9,12,31802,180,3,W
1950-07-19,0,BOS,9,5,20778,173,-4,NW
1950-07-20,0,BOS,5,6,9584,162,1,W
1950-07-21,0,BOS,4,7,23200,151,3,W
1950-07-22,0,BOS,2,11,9868,150,9,W
1950-07-23,0,BOS,2,6,19452,118,4,W
1950-08-15,1,BOS,3,8,0,137,5,W
1950-08-15,2,BOS,4,9,25519,145,5,W
1950-08-16,1,BOS,3,11,0,111,8,W
1950-08-16,2,BOS,7,12,22388,147,5,W
1950-08-17,0,BOS,6,10,11692,147,4,W
1950-08-18,0,BOS,6,7,21546,141,1,W
1950-08-19,0,BOS,4,5,10581,151,1,W
1950-08-22,0,BOS,5,9,20516,146,4,W
1950-08-23,0,BOS,5,9,8936,125,4,W
1950-08-24,0,BOS,2,6,7340,134,4,W
1950-08-25,0,BOS,2,6,34964,122,4,W
1950-08-26,0,BOS,8,6,29992,171,-2,NW
1950-08-27,0,BOS,9,11,31747,181,2,W
1950-08-28,0,BOS,14,15,28328,206,1,W
1950-08-29,0,BOS,6,13,8381,137,7,W
1950-08-30,0,BOS,1,6,9898,137,5,W
1950-08-31,0,BOS,3,4,5578,169,1,W
1950-09-06,0,BOS,2,11,34995,126,9,W
1950-09-07,0,BOS,8,10,29897,192,2,W
1950-09-09,1,BOS,3,8,0,137,5,W
1950-09-09,2,BOS,3,11,22153,117,8,W
1950-09-10,0,BOS,2,6,22147,115,4,W
1950-09-27,1,BOS,2,0,0,112,-2,NW
1950-09-27,2,BOS,6,3,8706,144,-3,NW
1950-09-28,0,BOS,3,4,2411,105,1,W
1950-09-29,0,BOS,6,7,2168,121,1,W
1950-09-30,0,BOS,6,5,26130,167,-1,NW
1950-10-01,0,BOS,3,7,27729,122,4,W
1951-04-20,0,BOS,6,3,11461,139,-3,NW
1951-04-21,0,BOS,3,6,13254,133,3,W
1951-04-22,1,BOS,5,6,0,144,1,W
1951-04-22,2,BOS,4,7,30026,130,3,W
1951-04-24,0,BOS,7,5,6188,141,-2,NW
1951-04-26,0,BOS,7,13,19120,210,6,W
1951-04-27,0,BOS,3,4,19144,155,1,W
1951-05-15,0,BOS,9,7,8923,206,-2,NW
1951-05-16,0,BOS,9,5,5828,135,-4,NW
1951-05-18,0,BOS,1,2,4566,141,1,W
1951-05-19,0,BOS,4,9,28908,154,5,W
1951-05-20,0,BOS,8,4,30320,144,-4,NW
1951-05-21,0,BOS,7,9,5934,145,2,W
1951-05-22,0,BOS,3,6,7995,144,3,W
1951-05-23,0,BOS,0,12,3586,127,12,W
1951-05-25,0,BOS,2,14,21379,132,12,W
1951-05-26,0,BOS,1,11,12500,129,10,W
1951-05-27,1,BOS,3,9,0,131,6,W
1951-05-27,2,BOS,1,7,24659,101,6,W
1951-05-28,0,BOS,2,3,31902,127,1,W
1951-05-30,1,BOS,10,11,0,253,1,W
1951-05-30,2,BOS,4,9,35824,139,5,W
1951-06-12,0,BOS,7,3,28775,163,-4,NW
1951-06-13,0,BOS,0,2,9390,122,2,W
1951-06-16,0,BOS,5,10,7272,153,5,W
1951-06-17,1,BOS,4,5,0,141,1,W
1951-06-17,2,BOS,0,3,21782,104,3,W
1951-06-18,0,BOS,9,7,12911,178,-2,NW
1951-06-19,0,BOS,2,9,31644,133,7,W
1951-06-20,0,BOS,14,8,11397,172,-6,NW
1951-06-21,0,BOS,8,4,9270,153,-4,NW
1951-06-22,0,BOS,5,6,33045,157,1,W
1951-06-23,0,BOS,7,8,17567,198,1,W
1951-06-24,1,BOS,6,5,0,140,-1,NW
1951-06-24,2,BOS,6,8,34869,155,2,W
1951-06-26,0,BOS,5,13,18979,141,8,W
1951-06-27,0,BOS,5,6,5034,144,1,W
1951-07-06,0,BOS,2,6,34138,150,4,W
1951-07-07,0,BOS,4,10,33164,165,6,W
1951-07-08,0,BOS,3,6,29843,145,3,W
1951-07-24,0,BOS,3,8,35327,139,5,W
1951-07-25,0,BOS,6,2,26794,131,-4,NW
1951-07-26,0,BOS,10,13,21679,224,3,W
1951-07-27,0,BOS,3,2,34298,170,-1,NW
1951-07-28,0,BOS,4,8,23199,252,4,W
1951-07-29,0,BOS,5,4,32180,143,-1,NW
1951-07-31,0,BOS,8,6,23365,171,-2,NW
1951-08-01,0,BOS,1,5,4854,130,4,W
1951-08-02,1,BOS,1,12,0,132,11,W
1951-08-02,2,BOS,6,11,23005,157,5,W
1951-08-03,0,BOS,2,5,31209,126,3,W
1951-08-04,0,BOS,2,1,22726,127,-1,NW
1951-08-05,1,BOS,3,1,0,131,-2,NW
1951-08-05,2,BOS,8,5,34546,168,-3,NW
1951-08-07,0,BOS,7,4,24234,147,-3,NW
1951-08-09,1,BOS,6,5,0,163,-1,NW
1951-08-09,2,BOS,3,5,16248,134,2,W
1951-08-10,0,BOS,4,6,28937,124,2,W
1951-08-11,0,BOS,7,1,12254,149,-6,NW
1951-08-12,1,BOS,2,6,0,130,4,W
1951-08-12,2,BOS,2,6,24253,123,4,W
1951-09-03,1,BOS,2,3,0,125,1,W
1951-09-03,2,BOS,4,8,26609,142,4,W
1951-09-11,0,BOS,3,4,7789,128,1,W
1951-09-12,0,BOS,1,2,8143,139,1,W
1951-09-13,0,BOS,4,5,5281,144,1,W
1951-09-14,0,BOS,6,9,5466,144,3,W
1951-09-15,0,BOS,3,2,14872,137,-1,NW
1951-09-16,0,BOS,4,5,29736,123,1,W
1951-09-17,0,BOS,5,12,8709,133,7,W
1951-09-18,0,BOS,6,4,20824,126,-2,NW
1951-09-19,0,BOS,15,2,23321,158,-13,NW
1951-09-21,0,BOS,5,1,21119,158,-4,NW
1951-09-22,0,BOS,0,5,31377,138,5,W
1951-09-23,0,BOS,6,1,28712,168,-5,NW
1952-04-18,0,BOS,4,5,12338,190,1,W
1952-04-19,1,BOS,2,11,8598,135,9,W
1952-04-19,2,BOS,1,6,23541,145,5,W
1952-04-20,0,BOS,3,6,21208,140,3,W
1952-04-21,0,BOS,3,2,4295,150,-1,NW
1952-04-22,0,BOS,5,10,3722,128,5,W
1952-04-23,0,BOS,1,3,15336,162,2,W
1952-04-24,0,BOS,2,3,14865,240,1,W
1952-04-30,0,BOS,3,5,24764,172,2,W
1952-05-01,0,BOS,6,1,4638,149,-5,NW
1952-05-02,0,BOS,6,13,4106,145,7,W
1952-05-03,0,BOS,2,5,12159,143,3,W
1952-05-04,0,BOS,9,6,32571,212,-3,NW
1952-05-05,0,BOS,4,2,8523,168,-2,NW
1952-05-06,0,BOS,2,11,16256,147,9,W
1952-05-07,0,BOS,2,7,3721,157,5,W
1952-05-08,0,BOS,4,2,5112,140,-2,NW
1952-05-24,0,BOS,2,5,30694,149,3,W
1952-05-26,0,BOS,3,6,29118,135,3,W
1952-05-27,0,BOS,7,3,13839,165,-4,NW
1952-05-29,0,BOS,0,1,16039,133,1,W
1952-05-30,1,BOS,5,2,0,151,-3,NW
1952-05-30,2,BOS,3,5,28767,160,2,W
1952-05-31,0,BOS,7,3,10562,154,-4,NW
1952-06-01,0,BOS,2,3,14584,142,1,W
1952-06-02,0,BOS,2,6,4967,133,4,W
1952-06-03,0,BOS,6,0,34904,162,-6,NW
1952-06-04,0,BOS,11,13,12351,183,2,W
1952-06-05,0,BOS,5,0,9607,157,-5,NW
1952-06-06,0,BOS,4,2,30808,152,-2,NW
1952-06-07,0,BOS,9,11,15602,186,2,W
1952-06-08,1,BOS,2,5,0,157,3,W
1952-06-08,2,BOS,2,5,33312,136,3,W
1952-06-09,0,BOS,8,9,5884,183,1,W
1952-06-10,0,BOS,7,4,19049,176,-3,NW
1952-06-11,0,BOS,9,11,14524,183,2,W
1952-06-12,0,BOS,5,7,5650,144,2,W
1952-06-27,0,BOS,5,3,26289,137,-2,NW
1952-06-28,0,BOS,5,1,11040,154,-4,NW
1952-07-11,1,BOS,6,16,0,148,10,W
1952-07-11,2,BOS,3,5,12655,139,2,W
1952-07-12,0,BOS,4,5,11394,132,1,W
1952-07-13,1,BOS,5,8,0,172,3,W
1952-07-13,2,BOS,0,4,22770,123,4,W
1952-07-14,0,BOS,7,5,4196,144,-2,NW
1952-07-15,0,BOS,5,7,24764,160,2,W
1952-07-16,0,BOS,3,7,11026,170,4,W
1952-07-17,0,BOS,1,2,6986,139,1,W
1952-07-18,0,BOS,2,9,34477,148,7,W
1952-07-19,0,BOS,4,0,18613,157,-4,NW
1952-07-20,0,BOS,7,8,25318,223,1,W
1952-08-12,0,BOS,4,3,17156,187,-1,NW
1952-08-13,0,BOS,0,4,9561,116,4,W
1952-08-14,1,BOS,4,5,0,213,1,W
1952-08-14,2,BOS,2,4,17022,132,2,W
1952-08-15,0,BOS,2,3,33418,142,1,W
1952-08-16,0,BOS,5,4,28635,125,-1,NW
1952-08-17,0,BOS,3,2,30531,165,-1,NW
1952-08-18,0,BOS,4,2,29596,132,-2,NW
1952-08-19,0,BOS,5,6,11238,138,1,W
1952-08-20,0,BOS,18,8,14409,188,-10,NW
1952-08-21,0,BOS,1,4,10243,106,3,W
1952-08-22,0,BOS,4,1,5367,116,-3,NW
1952-08-23,0,BOS,3,4,14851,113,1,W
1952-08-24,1,BOS,1,2,0,168,1,W
1952-08-24,2,BOS,1,12,26789,122,11,W
1952-08-26,0,BOS,3,11,26287,129,8,W
1952-08-27,0,BOS,0,5,10814,137,5,W
1952-09-06,1,BOS,4,6,0,136,2,W
1952-09-06,2,BOS,2,10,17905,145,8,W
1952-09-07,0,BOS,5,12,15658,144,7,W
1952-09-24,1,BOS,3,2,0,166,-1,NW
1952-09-24,2,BOS,8,6,17651,155,-2,NW
1952-09-25,0,BOS,3,2,7207,147,-1,NW
1952-09-26,0,BOS,1,3,1183,103,2,W
1952-09-27,0,BOS,3,2,5168,138,-1,NW
1952-09-28,0,BOS,5,4,9510,156,-1,NW
1953-04-20,1,BOS,2,4,5385,137,2,W
1953-04-20,2,BOS,4,11,7534,163,7,W
1953-04-24,0,BOS,7,2,5991,136,-5,NW
1953-04-25,0,BOS,3,4,6214,136,1,W
1953-05-08,0,BOS,1,2,33055,152,1,W
1953-05-09,0,BOS,6,4,26065,177,-2,NW
1953-05-10,0,BOS,7,4,28884,175,-3,NW
1953-05-12,0,BOS,9,7,21912,208,-2,NW
1953-05-13,0,BOS,0,3,3698,149,3,W
1953-05-14,0,BOS,4,5,4428,195,1,W
1953-05-16,0,BOS,0,1,18459,131,1,W
1953-05-18,1,BOS,5,2,0,145,-3,NW
1953-05-18,2,BOS,5,8,6591,147,3,W
1953-05-19,0,BOS,3,4,3733,130,1,W
1953-05-20,0,BOS,2,3,4121,186,1,W
1953-05-21,0,BOS,9,0,5816,152,-9,NW
1953-05-22,1,BOS,2,3,0,128,1,W
1953-05-22,2,BOS,2,3,4690,203,1,W
1953-05-31,1,BOS,5,4,0,163,-1,NW
1953-05-31,2,BOS,4,0,29590,115,-4,NW
1953-06-16,0,BOS,5,3,19151,150,-2,NW
1953-06-17,0,BOS,1,17,5750,173,16,W
1953-06-18,0,BOS,3,23,3108,183,20,W
1953-06-19,0,BOS,1,4,10567,143,3,W
1953-06-20,0,BOS,2,4,7203,130,2,W
1953-06-21,1,BOS,1,3,0,129,2,W
1953-06-21,2,BOS,2,0,15785,118,-2,NW
1953-06-23,1,BOS,4,6,5346,149,2,W
1953-06-23,2,BOS,1,2,28235,130,1,W
1953-06-24,0,BOS,13,9,8234,186,-4,NW
1953-06-25,0,BOS,15,4,5970,170,-11,NW
1953-06-26,0,BOS,5,3,20442,155,-2,NW
1953-06-27,0,BOS,6,5,15677,164,-1,NW
1953-06-28,0,BOS,13,4,19283,178,-9,NW
1953-06-30,0,BOS,4,5,32837,155,1,W
1953-07-01,0,BOS,0,4,16817,118,4,W
1953-07-02,0,BOS,5,3,14291,163,-2,NW
1953-07-03,0,BOS,9,4,14445,146,-5,NW
1953-07-04,1,BOS,2,7,0,133,5,W
1953-07-04,2,BOS,8,4,18355,134,-4,NW
1953-07-10,0,BOS,2,3,22657,206,1,W
1953-07-11,0,BOS,3,4,11692,153,1,W
1953-07-12,1,BOS,5,9,0,129,4,W
1953-07-12,2,BOS,4,1,23916,130,-3,NW
1953-07-28,0,BOS,4,2,35385,157,-2,NW
1953-07-29,0,BOS,8,3,19083,169,-5,NW
1953-07-30,0,BOS,17,1,10959,151,-16,NW
1953-07-31,0,BOS,5,3,21647,137,-2,NW
1953-08-01,0,BOS,4,3,10144,161,-1,NW
1953-08-02,1,BOS,2,1,0,137,-1,NW
1953-08-02,2,BOS,9,6,20434,147,-3,NW
1953-08-04,0,BOS,2,6,12318,139,4,W
1953-08-05,0,BOS,0,5,5027,115,5,W
1953-08-06,0,BOS,8,7,6792,184,-1,NW
1953-08-07,0,BOS,2,4,33728,148,2,W
1953-08-08,0,BOS,4,5,22731,149,1,W
1953-08-09,0,BOS,9,3,26966,146,-6,NW
1953-08-15,1,BOS,5,2,0,170,-3,NW
1953-08-15,2,BOS,4,2,24339,152,-2,NW
1953-08-16,1,BOS,1,4,0,177,3,W
1953-08-16,2,BOS,7,4,25564,139,-3,NW
1953-08-18,0,BOS,1,2,28024,144,1,W
1953-08-19,0,BOS,4,6,12084,147,2,W
1953-09-07,1,BOS,4,7,0,156,3,W
1953-09-07,2,BOS,5,3,32123,153,-2,NW
1953-09-09,0,BOS,2,1,29793,153,-1,NW
1953-09-10,0,BOS,4,14,8894,168,10,W
1953-09-11,0,BOS,2,0,3660,129,-2,NW
1953-09-12,0,BOS,6,7,10097,191,1,W
1953-09-13,0,BOS,6,7,22774,171,1,W
1953-09-14,0,BOS,10,6,5239,171,-4,NW
1953-09-15,0,BOS,6,0,4556,117,-6,NW
1953-09-16,0,BOS,8,3,2739,134,-5,NW
1953-09-17,0,BOS,1,2,2272,118,1,W
1953-09-19,0,BOS,0,3,24427,138,3,W
1953-09-20,0,BOS,10,8,29188,179,-2,NW
1954-04-15,0,BOS,1,6,17272,145,5,W
1954-04-18,1,BOS,6,4,0,155,-2,NW
1954-04-18,2,BOS,3,4,22566,196,1,W
1954-04-19,1,BOS,1,2,18682,151,1,W
1954-04-19,2,BOS,5,0,27762,151,-5,NW
1954-04-29,0,BOS,6,3,6595,158,-3,NW
1954-04-30,0,BOS,5,0,4199,140,-5,NW
1954-05-01,0,BOS,3,0,14932,142,-3,NW
1954-05-07,0,BOS,6,7,19110,148,1,W
1954-05-28,0,BOS,10,9,31034,203,-1,NW
1954-05-29,0,BOS,10,2,21992,150,-8,NW
1954-05-30,0,BOS,1,3,27407,150,2,W
1954-05-31,1,BOS,10,20,0,192,10,W
1954-05-31,2,BOS,0,9,23255,132,9,W
1954-06-01,0,BOS,16,6,2342,140,-10,NW
1954-06-02,0,BOS,2,5,20442,145,3,W
1954-06-03,0,BOS,9,6,5148,197,-3,NW
1954-06-04,0,BOS,7,3,2621,159,-4,NW
1954-06-05,1,BOS,6,0,4624,149,-6,NW
1954-06-05,2,BOS,4,5,19085,134,1,W
1954-06-06,0,BOS,4,7,15838,165,3,W
1954-06-07,1,BOS,2,3,0,136,1,W
1954-06-07,2,BOS,4,5,7135,208,1,W
1954-06-08,0,BOS,7,4,15769,152,-3,NW
1954-06-09,0,BOS,6,7,4682,165,1,W
1954-06-10,1,BOS,5,1,0,120,-4,NW
1954-06-10,2,BOS,9,0,6875,132,-9,NW
1954-06-11,0,BOS,6,2,28499,142,-4,NW
1954-06-12,0,BOS,4,3,18917,161,-1,NW
1954-06-13,1,BOS,4,1,0,145,-3,NW
1954-06-13,2,BOS,8,1,26750,139,-7,NW
1954-06-14,0,BOS,13,5,2572,170,-8,NW
1954-06-29,0,BOS,14,5,24828,194,-9,NW
1954-06-30,0,BOS,1,6,9399,145,5,W
1954-07-01,0,BOS,8,7,8118,181,-1,NW
1954-07-02,0,BOS,4,8,12913,138,4,W
1954-07-03,0,BOS,7,3,7232,155,-4,NW
1954-07-04,0,BOS,0,8,13861,140,8,W
1954-07-15,1,BOS,1,3,4801,132,2,W
1954-07-15,2,BOS,4,2,16893,146,-2,NW
1954-07-16,0,BOS,0,3,4872,120,3,W
1954-07-17,0,BOS,6,7,8796,151,1,W
1954-07-18,1,BOS,0,4,0,116,4,W
1954-07-18,2,BOS,4,1,16782,140,-3,NW
1954-07-19,1,BOS,7,9,0,161,2,W
1954-07-19,2,BOS,5,8,7033,144,3,W
1954-07-20,0,BOS,5,5,27852,266,0,NW
1954-07-21,0,BOS,7,7,8671,148,0,NW
1954-07-22,1,BOS,6,3,0,143,-3,NW
1954-07-22,2,BOS,5,2,16882,137,-3,NW
1954-07-23,0,BOS,7,1,18810,146,-6,NW
1954-07-24,0,BOS,2,5,12507,138,3,W
1954-07-25,1,BOS,5,2,0,148,-3,NW
1954-07-25,2,BOS,4,2,26068,157,-2,NW
1954-08-10,0,BOS,0,4,12367,118,4,W
1954-08-11,1,BOS,1,10,5903,118,9,W
1954-08-11,2,BOS,5,4,17133,144,-1,NW
1954-08-12,1,BOS,9,5,0,150,-4,NW
1954-08-12,2,BOS,0,5,7783,126,5,W
1954-08-20,0,BOS,3,4,30174,160,1,W
1954-08-21,0,BOS,9,10,25003,241,1,W
1954-08-22,0,BOS,2,8,30046,146,6,W
1954-08-24,0,BOS,8,7,17637,186,-1,NW
1954-08-25,0,BOS,3,5,7856,134,2,W
1954-08-26,0,BOS,5,3,10710,141,-2,NW
1954-08-27,0,BOS,2,3,4048,130,1,W
1954-08-28,0,BOS,2,3,8104,180,1,W
1954-08-29,1,BOS,6,2,0,156,-4,NW
1954-08-29,2,BOS,8,1,36344,157,-7,NW
1954-08-30,0,BOS,5,4,11426,176,-1,NW
1954-09-01,1,BOS,2,7,5320,152,5,W
1954-09-01,2,BOS,6,3,10854,151,-3,NW
1954-09-20,0,BOS,2,5,1555,122,3,W
1954-09-21,1,BOS,3,4,0,157,1,W
1954-09-21,2,BOS,3,4,2774,149,1,W
1954-09-24,1,BOS,1,0,0,143,-1,NW
1954-09-24,2,BOS,6,4,3931,154,-2,NW
1954-09-25,0,BOS,6,7,6727,139,1,W
1954-09-26,0,BOS,2,11,14175,134,9,W
1955-04-14,0,BOS,4,8,22246,152,4,W
1955-04-15,0,BOS,6,4,8770,133,-2,NW
1955-04-16,0,BOS,5,6,7120,151,1,W
1955-04-17,1,BOS,5,14,0,159,9,W
1955-04-17,2,BOS,9,12,15345,188,3,W
1955-05-06,0,BOS,6,0,7033,158,-6,NW
1955-05-07,0,BOS,9,6,29925,202,-3,NW
1955-05-08,0,BOS,5,0,16097,137,-5,NW
1955-05-10,0,BOS,4,2,3363,131,-2,NW
1955-05-11,0,BOS,3,4,3354,138,1,W
1955-05-12,0,BOS,7,12,3900,147,5,W
1955-05-13,0,BOS,3,4,17953,141,1,W
1955-05-14,0,BOS,1,3,8213,186,2,W
1955-05-15,1,BOS,4,10,0,151,6,W
1955-05-15,2,BOS,9,3,28752,162,-6,NW
1955-05-17,0,BOS,3,10,4646,162,7,W
1955-05-18,0,BOS,19,0,11490,157,-19,NW
1955-05-27,0,BOS,0,16,15775,149,16,W
1955-05-28,0,BOS,5,3,9162,173,-2,NW
1955-05-29,0,BOS,7,12,14429,180,5,W
1955-05-30,1,BOS,8,6,0,165,-2,NW
1955-05-30,2,BOS,1,8,17732,146,7,W
1955-06-14,0,BOS,4,12,4277,133,8,W
1955-06-15,0,BOS,6,9,4939,142,3,W
1955-06-16,0,BOS,6,7,3983,123,1,W
1955-06-17,1,BOS,5,6,10612,170,1,W
1955-06-17,2,BOS,3,2,33014,145,-1,NW
1955-06-18,0,BOS,2,4,18430,137,2,W
1955-06-19,0,BOS,7,11,26080,183,4,W
1955-06-21,0,BOS,4,5,25332,165,1,W
1955-06-22,0,BOS,7,12,11484,175,5,W
1955-06-23,0,BOS,0,7,9316,130,7,W
1955-06-24,0,BOS,3,2,28628,167,-1,NW
1955-06-25,0,BOS,8,3,15823,151,-5,NW
1955-06-26,1,BOS,2,5,0,138,3,W
1955-06-26,2,BOS,2,8,32362,152,6,W
1955-07-06,0,BOS,5,7,30407,147,2,W
1955-07-07,0,BOS,5,6,17927,152,1,W
1955-07-08,0,BOS,9,3,24520,177,-6,NW
1955-07-09,0,BOS,4,5,10506,176,1,W
1955-07-10,0,BOS,7,10,20774,154,3,W
1955-07-26,0,BOS,1,5,33423,143,4,W
1955-07-27,0,BOS,2,6,25341,146,4,W
1955-07-28,0,BOS,6,4,17064,179,-2,NW
1955-07-29,0,BOS,0,5,32631,130,5,W
1955-07-30,0,BOS,5,2,22481,149,-3,NW
1955-07-31,1,BOS,3,8,0,134,5,W
1955-07-31,2,BOS,2,3,35057,171,1,W
1955-08-02,0,BOS,2,1,35455,165,-1,NW
1955-08-03,0,BOS,4,6,25318,167,2,W
1955-08-04,0,BOS,3,7,19346,161,4,W
1955-08-05,0,BOS,5,2,22299,135,-3,NW
1955-08-06,0,BOS,6,5,9924,178,-1,NW
1955-08-07,0,BOS,12,16,13488,174,4,W
1955-08-13,0,BOS,18,9,7888,179,-9,NW
1955-08-14,1,BOS,6,9,0,168,3,W
1955-08-14,2,BOS,1,2,21003,109,1,W
1955-08-15,0,BOS,4,8,20624,149,4,W
1955-08-16,0,BOS,13,6,34152,170,-7,NW
1955-08-17,0,BOS,1,7,31871,151,6,W
1955-09-05,1,BOS,2,10,0,148,8,W
1955-09-05,2,BOS,2,7,29769,142,5,W
1955-09-07,0,BOS,4,7,14370,136,3,W
1955-09-08,0,BOS,5,4,13514,141,-1,NW
1955-09-09,0,BOS,3,1,30127,176,-2,NW
1955-09-10,0,BOS,10,7,23550,204,-3,NW
1955-09-11,1,BOS,2,6,0,142,4,W
1955-09-11,2,BOS,7,2,29473,176,-5,NW
1955-09-13,1,BOS,6,5,0,206,-1,NW
1955-09-13,2,BOS,6,7,10256,164,1,W
1955-09-14,0,BOS,7,3,4442,132,-4,NW
1955-09-20,1,BOS,3,2,0,158,-1,NW
1955-09-20,2,BOS,7,4,2101,158,-3,NW
1955-09-21,0,BOS,8,7,1964,233,-1,NW
1955-09-23,1,BOS,4,8,10849,176,4,W
1955-09-23,2,BOS,3,2,25158,182,-1,NW
1955-09-25,1,BOS,9,2,0,134,-7,NW
1955-09-25,2,BOS,1,8,26228,127,7,W
1956-04-17,0,BOS,1,8,32563,139,7,W
1956-04-18,0,BOS,4,8,8759,165,4,W
1956-04-19,0,BOS,2,4,23962,121,2,W
1956-04-25,0,BOS,4,1,4638,143,-3,NW
1956-04-27,0,BOS,5,2,12626,156,-3,NW
1956-04-28,0,BOS,4,6,27357,177,2,W
1956-05-01,0,BOS,3,2,4224,128,-1,NW
1956-05-02,0,BOS,0,2,3825,119,2,W
1956-05-03,0,BOS,2,5,4600,126,3,W
1956-05-04,0,BOS,4,6,6735,172,2,W
1956-05-05,0,BOS,16,4,17730,170,-12,NW
1956-05-07,0,BOS,1,5,4396,140,4,W
1956-05-08,0,BOS,3,4,4706,202,1,W
1956-05-09,0,BOS,5,7,7611,168,2,W
1956-05-10,0,BOS,2,1,5282,154,-1,NW
1956-05-25,0,BOS,10,5,24879,155,-5,NW
1956-05-26,0,BOS,4,1,10753,137,-3,NW
1956-05-27,1,BOS,7,9,0,125,2,W
1956-05-27,2,BOS,11,10,11574,185,-1,NW
1956-06-01,0,BOS,0,5,21856,137,5,W
1956-06-02,0,BOS,11,3,9805,148,-8,NW
1956-06-03,0,BOS,7,6,20097,177,-1,NW
1956-06-05,0,BOS,14,11,26649,180,-3,NW
1956-06-06,0,BOS,4,5,7161,148,1,W
1956-06-07,0,BOS,5,6,6905,172,1,W
1956-06-08,0,BOS,3,5,23928,152,2,W
1956-06-09,0,BOS,8,0,16730,159,-8,NW
1956-06-10,0,BOS,3,2,25453,146,-1,NW
1956-06-11,1,BOS,4,1,6330,133,-3,NW
1956-06-11,2,BOS,1,5,24193,140,4,W
1956-06-12,0,BOS,7,9,29190,157,2,W
1956-06-13,0,BOS,8,8,8258,232,0,NW
1956-06-14,0,BOS,9,10,7136,184,1,W
1956-07-04,1,BOS,6,7,0,195,1,W
1956-07-04,2,BOS,9,4,34594,178,-5,NW
1956-07-05,0,BOS,6,1,15860,136,-5,NW
1956-07-07,0,BOS,3,4,10320,144,1,W
1956-07-08,1,BOS,0,9,0,138,9,W
1956-07-08,2,BOS,4,8,20723,138,4,W
1956-07-12,0,BOS,1,3,28092,135,2,W
1956-07-13,0,BOS,4,5,12438,145,1,W
1956-07-14,0,BOS,0,4,14542,102,4,W
1956-07-15,1,BOS,10,7,0,182,-3,NW
1956-07-15,2,BOS,1,3,32290,142,2,W
1956-07-16,0,BOS,7,3,14262,133,-4,NW
1956-07-17,1,BOS,0,10,0,121,10,W
1956-07-17,2,BOS,0,1,24441,140,1,W
1956-07-18,0,BOS,4,7,8028,131,3,W
1956-07-19,0,BOS,8,4,7436,153,-4,NW
1956-07-20,0,BOS,9,6,29806,177,-3,NW
1956-07-21,0,BOS,3,9,9937,140,6,W
1956-07-22,0,BOS,6,8,21343,164,2,W
1956-08-06,0,BOS,4,3,35923,167,-1,NW
1956-08-07,0,BOS,0,1,36350,181,1,W
1956-08-08,0,BOS,2,7,23981,157,5,W
1956-08-09,0,BOS,1,3,9218,127,2,W
1956-08-17,0,BOS,6,5,23610,132,-1,NW
1956-08-18,0,BOS,9,7,9762,172,-2,NW
1956-08-19,1,BOS,7,5,0,133,-2,NW
1956-08-19,2,BOS,11,10,20503,186,-1,NW
1956-08-22,1,BOS,6,3,10118,167,-3,NW
1956-08-22,2,BOS,6,7,11305,180,1,W
1956-08-23,0,BOS,1,2,26439,130,1,W
1956-08-24,0,BOS,5,3,6047,153,-2,NW
1956-08-25,0,BOS,6,9,19830,168,3,W
1956-08-26,1,BOS,1,2,0,141,1,W
1956-08-26,2,BOS,7,6,21389,165,-1,NW
1956-08-28,0,BOS,6,3,9219,136,-3,NW
1956-08-29,0,BOS,2,4,11210,152,2,W
1956-08-31,0,BOS,13,6,10706,180,-7,NW
1956-09-01,0,BOS,2,4,5819,151,2,W
1956-09-02,0,BOS,11,10,12529,197,-1,NW
1956-09-05,0,BOS,5,3,26784,162,-2,NW
1956-09-21,0,BOS,7,13,24616,203,6,W
1956-09-22,0,BOS,2,1,22333,171,-1,NW
1956-09-23,0,BOS,7,4,21663,150,-3,NW
1956-09-25,0,BOS,4,10,2073,136,6,W
1956-09-26,0,BOS,4,8,2208,142,4,W
1957-04-18,0,BOS,3,2,30468,128,-1,NW
1957-04-20,0,BOS,10,7,21997,235,-3,NW
1957-04-21,0,BOS,4,5,17565,145,1,W
1957-04-22,0,BOS,7,5,6982,178,-2,NW
1957-04-23,0,BOS,1,3,6594,126,2,W
1957-05-12,1,BOS,0,10,0,155,10,W
1957-05-12,2,BOS,6,2,13975,156,-4,NW
1957-05-13,0,BOS,5,3,21835,145,-2,NW
1957-05-14,0,BOS,2,0,5234,116,-2,NW
1957-05-15,0,BOS,8,11,5622,190,3,W
1957-05-16,0,BOS,2,1,5274,132,-1,NW
1957-05-17,0,BOS,3,4,20438,153,1,W
1957-05-18,0,BOS,7,5,11982,169,-2,NW
1957-05-19,0,BOS,6,2,22743,132,-4,NW
1957-05-21,0,BOS,8,2,4280,179,-6,NW
1957-05-22,0,BOS,0,11,6257,140,11,W
1957-05-27,0,BOS,17,8,29865,190,-9,NW
1957-05-28,0,BOS,8,5,13063,196,-3,NW
1957-05-29,0,BOS,3,1,2617,163,-2,NW
1957-05-30,1,BOS,6,7,0,173,1,W
1957-05-30,2,BOS,5,16,24339,165,11,W
1957-06-18,0,BOS,7,6,28510,160,-1,NW
1957-06-19,0,BOS,0,6,6699,131,6,W
1957-06-20,0,BOS,7,9,6437,182,2,W
1957-06-21,0,BOS,3,4,22230,118,1,W
1957-06-22,0,BOS,1,5,10760,130,4,W
1957-06-23,1,BOS,6,10,0,155,4,W
1957-06-23,2,BOS,1,10,21337,128,9,W
1957-06-25,0,BOS,2,1,27764,145,-1,NW
1957-06-26,0,BOS,7,5,9921,175,-2,NW
1957-06-27,1,BOS,3,8,0,159,5,W
1957-06-27,2,BOS,2,9,15535,148,7,W
1957-06-28,0,BOS,2,9,30189,152,7,W
1957-06-29,0,BOS,4,12,16545,144,8,W
1957-06-30,0,BOS,3,10,24502,148,7,W
1957-07-01,0,BOS,5,4,21092,177,-1,NW
1957-07-02,0,BOS,1,2,8774,117,1,W
1957-07-05,0,BOS,5,7,26091,171,2,W
1957-07-06,0,BOS,2,11,13390,153,9,W
1957-07-07,0,BOS,8,4,14758,133,-4,NW
1957-07-23,0,BOS,0,1,16324,136,1,W
1957-07-24,0,BOS,5,6,8485,139,1,W
1957-07-25,0,BOS,3,5,6159,142,2,W
1957-07-26,0,BOS,1,10,28131,158,9,W
1957-07-27,0,BOS,7,2,16454,177,-5,NW
1957-07-28,0,BOS,8,9,22351,161,1,W
1957-07-29,0,BOS,2,6,10535,156,4,W
1957-07-30,0,BOS,0,4,26817,130,4,W
1957-07-31,0,BOS,5,3,15154,164,-2,NW
1957-08-01,0,BOS,7,5,9302,174,-2,NW
1957-08-02,0,BOS,4,5,31007,179,1,W
1957-08-03,0,BOS,7,8,18476,209,1,W
1957-08-04,0,BOS,11,6,20194,167,-5,NW
1957-08-09,0,BOS,8,0,21621,144,-8,NW
1957-08-10,0,BOS,1,4,9045,117,3,W
1957-08-11,1,BOS,5,8,0,163,3,W
1957-08-11,2,BOS,3,4,21757,151,1,W
1957-08-13,0,BOS,3,2,35647,147,-1,NW
1957-08-14,0,BOS,4,6,36207,148,2,W
1957-08-15,0,BOS,6,3,30004,189,-3,NW
1957-09-02,1,BOS,1,7,0,118,6,W
1957-09-02,2,BOS,7,8,25468,168,1,W
1957-09-06,0,BOS,3,4,16750,139,1,W
1957-09-07,0,BOS,3,4,9775,143,1,W
1957-09-08,0,BOS,0,2,12727,119,2,W
1957-09-10,0,BOS,4,7,20773,174,3,W
1957-09-11,0,BOS,4,1,6216,172,-3,NW
1957-09-12,0,BOS,7,1,5370,133,-6,NW
1957-09-13,0,BOS,16,3,20064,168,-13,NW
1957-09-14,0,BOS,10,13,10137,175,3,W
1957-09-15,1,BOS,7,1,0,150,-6,NW
1957-09-15,2,BOS,4,3,27834,145,-1,NW
1957-09-17,0,BOS,8,9,12084,174,1,W
1957-09-18,0,BOS,2,1,3611,105,-1,NW
1957-09-27,0,BOS,10,2,6572,131,-8,NW
1957-09-28,0,BOS,2,0,19063,137,-2,NW
1957-09-29,0,BOS,2,3,25406,105,1,W
1958-04-15,0,BOS,3,0,35233,118,-3,NW
1958-04-16,0,BOS,1,3,13337,126,2,W
1958-04-17,0,BOS,3,1,15033,120,-2,NW
1958-04-23,0,BOS,5,7,6695,167,2,W
1958-04-24,0,BOS,3,4,6690,160,1,W
1958-04-25,0,BOS,2,0,5799,141,-2,NW
1958-04-26,0,BOS,7,5,10287,161,-2,NW
1958-04-27,0,BOS,5,7,11908,146,2,W
1958-04-30,0,BOS,11,4,4037,142,-7,NW
1958-05-01,0,BOS,6,7,4897,167,1,W
1958-05-02,0,BOS,0,6,5653,153,6,W
1958-05-04,1,BOS,2,1,0,139,-1,NW
1958-05-04,2,BOS,1,2,23029,190,1,W
1958-05-05,0,BOS,5,8,2387,164,3,W
1958-05-06,0,BOS,5,7,3376,181,2,W
1958-05-17,1,BOS,4,7,10610,168,3,W
1958-05-17,2,BOS,5,3,16266,155,-2,NW
1958-05-18,0,BOS,4,8,17933,144,4,W
1958-05-31,0,BOS,5,4,27455,180,-1,NW
1958-06-01,0,BOS,10,4,28954,140,-6,NW
1958-06-03,0,BOS,3,7,20665,165,4,W
1958-06-04,0,BOS,7,5,5745,188,-2,NW
1958-06-05,0,BOS,3,5,4129,158,2,W
1958-06-06,0,BOS,2,3,22506,159,1,W
1958-06-07,0,BOS,6,7,13924,182,1,W
1958-06-08,1,BOS,5,6,0,181,1,W
1958-06-08,2,BOS,1,4,24983,120,3,W
1958-06-09,0,BOS,4,9,18473,155,5,W
1958-06-11,1,BOS,7,0,4983,133,-7,NW
1958-06-11,2,BOS,9,3,12833,179,-6,NW
1958-06-12,0,BOS,2,4,5168,155,2,W
1958-06-13,0,BOS,3,9,25000,143,6,W
1958-06-14,0,BOS,1,7,11083,121,6,W
1958-06-15,1,BOS,17,6,0,170,-11,NW
1958-06-15,2,BOS,9,4,29014,126,-5,NW
1958-07-01,0,BOS,5,10,23958,164,5,W
1958-07-02,0,BOS,5,3,7851,135,-2,NW
1958-07-03,0,BOS,7,5,3921,263,-2,NW
1958-07-04,1,BOS,1,5,0,136,4,W
1958-07-04,2,BOS,5,3,19387,131,-2,NW
1958-07-10,0,BOS,2,11,25471,169,9,W
1958-07-11,0,BOS,1,6,8914,142,5,W
1958-07-12,1,BOS,7,4,0,170,-3,NW
1958-07-12,2,BOS,13,5,14991,158,-8,NW
1958-07-13,0,BOS,9,4,15897,166,-5,NW
1958-07-14,0,BOS,3,4,7184,203,1,W
1958-07-15,0,BOS,2,5,19090,160,3,W
1958-07-16,0,BOS,2,5,20316,138,3,W
1958-07-17,0,BOS,2,6,9972,130,4,W
1958-07-18,0,BOS,9,11,28430,200,2,W
1958-07-19,0,BOS,6,7,12842,171,1,W
1958-07-20,1,BOS,3,0,0,122,-3,NW
1958-07-20,2,BOS,2,5,29529,146,3,W
1958-08-05,0,BOS,1,7,23030,133,6,W
1958-08-06,0,BOS,2,8,9783,128,6,W
1958-08-07,0,BOS,4,8,5850,132,4,W
1958-08-14,0,BOS,8,2,29728,158,-6,NW
1958-08-15,0,BOS,2,6,30115,165,4,W
1958-08-16,0,BOS,4,7,24925,152,3,W
1958-08-17,0,BOS,5,6,30501,148,1,W
1958-08-19,0,BOS,7,1,27544,149,-6,NW
1958-08-20,0,BOS,10,8,12401,183,-2,NW
1958-08-21,0,BOS,6,8,19317,150,2,W
1958-08-22,0,BOS,3,4,13421,145,1,W
1958-08-23,0,BOS,8,1,12895,167,-7,NW
1958-08-24,1,BOS,3,14,0,163,11,W
1958-08-24,2,BOS,2,3,22952,156,1,W
1958-08-27,1,BOS,2,3,11946,131,1,W
1958-08-27,2,BOS,7,2,17258,140,-5,NW
1958-08-29,0,BOS,2,5,16411,122,3,W
1958-08-30,0,BOS,7,2,9887,147,-5,NW
1958-08-31,0,BOS,2,3,13112,112,1,W
1958-09-19,0,BOS,0,2,9334,141,2,W
1958-09-20,0,BOS,0,2,7400,125,2,W
1958-09-21,0,BOS,0,2,9785,130,2,W
1958-09-23,0,BOS,8,9,21552,188,1,W
1958-09-24,0,BOS,7,5,8865,169,-2,NW
1959-04-14,0,BOS,3,7,16467,168,4,W
1959-04-15,0,BOS,3,7,3498,152,4,W
1959-04-16,0,BOS,7,5,4334,145,-2,NW
1959-04-17,0,BOS,0,4,8878,129,4,W
1959-04-18,0,BOS,16,7,16882,195,-9,NW
1959-04-19,0,BOS,4,5,20707,220,1,W
1959-04-21,0,BOS,5,2,6358,145,-3,NW
1959-04-22,0,BOS,4,8,6866,159,4,W
1959-04-23,0,BOS,8,7,7296,202,-1,NW
1959-05-12,0,BOS,4,3,22012,263,-1,NW
1959-05-13,0,BOS,4,0,4787,139,-4,NW
1959-05-14,0,BOS,14,6,3554,188,-8,NW
1959-05-15,0,BOS,4,3,23412,152,-1,NW
1959-05-16,0,BOS,12,6,16057,184,-6,NW
1959-05-17,0,BOS,1,10,17180,162,9,W
1959-05-18,0,BOS,14,2,3028,159,-12,NW
1959-05-20,0,BOS,8,2,3256,150,-6,NW
1959-05-21,0,BOS,0,5,2572,185,5,W
1959-05-22,0,BOS,3,4,15109,149,1,W
1959-05-23,0,BOS,10,4,10606,181,-6,NW
1959-05-24,0,BOS,8,3,9484,163,-5,NW
1959-05-30,1,BOS,4,5,0,173,1,W
1959-05-30,2,BOS,3,8,19403,147,5,W
1959-05-31,0,BOS,2,1,12506,158,-1,NW
1959-06-08,0,BOS,6,3,17119,160,-3,NW
1959-06-09,0,BOS,2,5,14573,155,3,W
1959-06-10,0,BOS,10,9,4343,180,-1,NW
1959-06-11,0,BOS,8,1,3248,153,-7,NW
1959-06-12,0,BOS,3,2,13434,154,-1,NW
1959-06-13,0,BOS,1,6,5513,125,5,W
1959-06-14,0,BOS,1,6,8160,152,5,W
1959-06-15,0,BOS,5,1,12322,166,-4,NW
1959-06-16,0,BOS,4,1,16656,142,-3,NW
1959-06-18,0,BOS,6,7,3386,176,1,W
1959-06-20,1,BOS,2,8,12997,162,6,W
1959-06-20,2,BOS,0,9,16067,168,9,W
1959-06-21,0,BOS,3,2,21094,139,-1,NW
1959-07-09,0,BOS,3,14,30253,170,11,W
1959-07-10,0,BOS,5,8,25882,175,3,W
1959-07-11,0,BOS,4,8,24232,238,4,W
1959-07-12,0,BOS,3,7,29626,161,4,W
1959-07-13,0,BOS,3,13,22064,189,10,W
1959-07-14,0,BOS,7,3,20606,180,-4,NW
1959-07-16,1,BOS,4,3,0,160,-1,NW
1959-07-16,2,BOS,4,5,17285,180,1,W
1959-07-17,0,BOS,8,7,26432,187,-1,NW
1959-07-18,0,BOS,7,5,14453,253,-2,NW
1959-07-19,1,BOS,5,6,0,168,1,W
1959-07-19,2,BOS,5,3,27753,158,-2,NW
1959-08-04,1,BOS,1,4,0,133,3,W
1959-08-04,2,BOS,8,6,21304,187,-2,NW
1959-08-05,0,BOS,6,17,15980,178,11,W
1959-08-06,0,BOS,3,4,7673,153,1,W
1959-08-07,0,BOS,3,4,21099,152,1,W
1959-08-08,0,BOS,3,4,13930,192,1,W
1959-08-09,0,BOS,7,3,12500,175,-4,NW
1959-08-10,0,BOS,7,4,32004,215,-3,NW
1959-08-11,0,BOS,8,5,25032,170,-3,NW
1959-08-28,0,BOS,4,6,18071,174,2,W
1959-08-29,0,BOS,1,4,10114,145,3,W
1959-08-30,0,BOS,0,3,11134,127,3,W
1959-08-31,0,BOS,3,4,21907,182,1,W
1959-09-01,0,BOS,7,4,6317,180,-3,NW
1959-09-07,0,BOS,4,12,19995,184,8,W
1959-09-09,0,BOS,3,1,13406,175,-2,NW
1959-09-10,0,BOS,3,7,3294,150,4,W
1959-09-11,0,BOS,8,6,10409,148,-2,NW
1959-09-12,0,BOS,3,4,7156,153,1,W
1959-09-13,0,BOS,3,1,26720,135,-2,NW
1959-09-14,0,BOS,3,9,3676,156,6,W
1959-09-15,0,BOS,0,1,8456,126,1,W
1959-09-16,0,BOS,5,6,3006,158,1,W
1959-09-22,0,BOS,3,4,9344,136,1,W
1959-09-23,0,BOS,0,4,2199,117,4,W
1959-09-25,0,BOS,4,10,9089,182,6,W
1959-09-26,0,BOS,4,5,5428,168,1,W
1959-09-27,0,BOS,2,6,9110,142,4,W
1960-04-19,0,BOS,8,4,35162,182,-4,NW
1960-04-20,0,BOS,1,7,11836,156,6,W
1960-04-21,0,BOS,4,0,11501,143,-4,NW
1960-04-30,0,BOS,1,2,8126,170,1,W
1960-05-03,0,BOS,3,4,3914,188,1,W
1960-05-04,0,BOS,5,3,3922,165,-2,NW
1960-05-06,0,BOS,2,3,3987,165,1,W
1960-05-07,0,BOS,0,5,11619,160,5,W
1960-05-10,0,BOS,7,9,16509,198,2,W
1960-05-12,0,BOS,0,1,4877,124,1,W
1960-05-14,0,BOS,5,2,10703,145,-3,NW
1960-05-15,1,BOS,2,1,0,150,-1,NW
1960-05-15,2,BOS,7,4,21157,149,-3,NW
1960-05-31,0,BOS,1,5,7320,143,4,W
1960-06-02,1,BOS,8,3,0,160,-5,NW
1960-06-02,2,BOS,8,7,4924,209,-1,NW
1960-06-07,0,BOS,12,3,19269,155,-9,NW
1960-06-08,1,BOS,8,7,0,141,-1,NW
1960-06-08,2,BOS,5,2,11193,155,-3,NW
1960-06-09,0,BOS,3,2,4002,141,-1,NW
1960-06-10,0,BOS,13,3,21015,157,-10,NW
1960-06-11,1,BOS,4,5,14447,169,1,W
1960-06-11,2,BOS,8,4,7813,172,-4,NW
1960-06-12,0,BOS,1,4,20417,127,3,W
1960-06-28,0,BOS,10,1,20366,185,-9,NW
1960-06-29,0,BOS,2,4,5829,135,2,W
1960-06-30,0,BOS,7,11,4170,176,4,W
1960-07-02,0,BOS,10,6,7837,172,-4,NW
1960-07-03,0,BOS,2,13,10291,173,11,W
1960-07-04,1,BOS,7,10,0,159,3,W
1960-07-04,2,BOS,8,6,20206,172,-2,NW
1960-07-05,0,BOS,9,4,17302,170,-5,NW
1960-07-06,0,BOS,4,0,11093,153,-4,NW
1960-07-07,1,BOS,6,5,0,157,-1,NW
1960-07-07,2,BOS,2,4,10932,127,2,W
1960-07-08,0,BOS,0,8,32437,151,8,W
1960-07-09,0,BOS,5,6,24423,177,1,W
1960-07-10,0,BOS,5,9,28643,158,4,W
1960-07-22,0,BOS,4,6,29595,160,2,W
1960-07-23,0,BOS,4,2,13328,136,-2,NW
1960-07-24,1,BOS,6,10,0,154,4,W
1960-07-24,2,BOS,6,7,30415,163,1,W
1960-07-26,0,BOS,16,3,31623,204,-13,NW
1960-07-27,0,BOS,10,4,14780,168,-6,NW
1960-07-28,0,BOS,2,4,11175,136,2,W
1960-07-29,0,BOS,0,1,24627,125,1,W
1960-07-31,1,BOS,9,6,0,163,-3,NW
1960-07-31,2,BOS,4,8,30334,150,4,W
1960-08-01,0,BOS,10,8,13782,213,-2,NW
1960-08-02,0,BOS,10,4,16321,158,-6,NW
1960-08-04,1,BOS,3,5,0,139,2,W
1960-08-04,2,BOS,1,9,16156,141,8,W
1960-08-17,0,BOS,3,2,29686,172,-1,NW
1960-08-18,0,BOS,11,7,29471,204,-4,NW
1960-08-20,1,BOS,6,8,17437,154,2,W
1960-08-20,2,BOS,6,0,20177,129,-6,NW
1960-08-21,0,BOS,10,4,23141,143,-6,NW
1960-08-23,0,BOS,3,2,29232,170,-1,NW
1960-08-24,0,BOS,3,1,19548,152,-2,NW
1960-08-25,0,BOS,7,10,15398,130,3,W
1960-08-26,0,BOS,9,2,29750,160,-7,NW
1960-08-27,0,BOS,9,6,20936,167,-3,NW
1960-08-28,1,BOS,1,2,0,105,1,W
1960-08-28,2,BOS,4,5,22355,129,1,W
1960-08-29,0,BOS,1,4,10426,149,3,W
1960-08-30,1,BOS,4,5,0,246,1,W
1960-08-30,2,BOS,2,3,27176,170,1,W
1960-08-31,0,BOS,4,2,14562,176,-2,NW
1960-09-02,1,BOS,5,1,0,145,-4,NW
1960-09-02,2,BOS,3,2,26817,156,-1,NW
1960-09-03,0,BOS,4,5,13599,147,1,W
1960-09-04,0,BOS,4,5,10321,144,1,W
1960-09-23,0,BOS,5,1,10880,151,-4,NW
1960-09-24,0,BOS,6,5,30761,221,-1,NW
1960-09-25,0,BOS,4,3,32420,139,-1,NW
1960-09-27,0,BOS,17,3,5840,181,-14,NW
1960-09-28,0,BOS,4,5,10454,138,1,W
1961-04-11,0,BOS,5,2,10277,208,-3,NW
1961-04-15,0,BOS,0,3,7165,157,3,W
1961-04-17,0,BOS,2,3,5289,165,1,W
1961-04-18,0,BOS,3,2,2309,163,-1,NW
1961-04-25,0,BOS,1,6,2748,145,5,W
1961-04-26,0,BOS,2,1,2133,144,-1,NW
1961-05-15,0,BOS,13,2,3130,160,-11,NW
1961-05-16,0,BOS,7,8,6769,174,1,W
1961-05-17,0,BOS,1,0,4198,149,-1,NW
1961-05-18,0,BOS,0,1,7726,129,1,W
1961-05-20,0,BOS,3,4,10085,151,1,W
1961-05-21,1,BOS,6,5,0,201,-1,NW
1961-05-21,2,BOS,1,4,21895,120,3,W
1961-05-22,0,BOS,1,4,7487,154,3,W
1961-05-29,0,BOS,1,2,21804,129,1,W
1961-05-30,0,BOS,12,3,19592,176,-9,NW
1961-05-31,0,BOS,7,6,17318,172,-1,NW
1961-06-01,0,BOS,5,7,5257,188,2,W
1961-06-02,0,BOS,2,4,17714,123,2,W
1961-06-03,0,BOS,3,1,9156,130,-2,NW
1961-06-04,0,BOS,5,6,14409,177,1,W
1961-06-05,1,BOS,2,6,0,132,4,W
1961-06-05,2,BOS,10,6,4356,172,-4,NW
1961-06-06,0,BOS,3,5,8713,148,2,W
1961-06-07,0,BOS,2,6,3100,153,4,W
1961-06-08,1,BOS,5,6,0,155,1,W
1961-06-08,2,BOS,4,4,11042,201,0,NW
1961-06-09,1,BOS,3,5,0,120,2,W
1961-06-09,2,BOS,5,1,8379,170,-4,NW
1961-06-10,0,BOS,10,5,4675,167,-5,NW
1961-06-11,1,BOS,2,8,0,172,6,W
1961-06-11,2,BOS,10,5,18809,165,-5,NW
1961-06-12,0,BOS,8,10,2984,213,2,W
1961-06-16,0,BOS,9,14,14081,224,5,W
1961-06-17,0,BOS,5,6,6283,136,1,W
1961-06-18,1,BOS,12,13,0,167,1,W
1961-06-18,2,BOS,5,6,17645,214,1,W
1961-06-30,0,BOS,10,2,26143,155,-8,NW
1961-07-01,0,BOS,7,3,11085,151,-4,NW
1961-07-02,0,BOS,12,6,15188,180,-6,NW
1961-07-05,1,BOS,6,2,7785,144,-4,NW
1961-07-05,2,BOS,3,8,19965,147,5,W
1961-07-06,0,BOS,3,0,13008,147,-3,NW
1961-07-13,0,BOS,2,3,18012,113,1,W
1961-07-14,0,BOS,7,6,11325,205,-1,NW
1961-07-15,0,BOS,1,2,7527,136,1,W
1961-07-21,0,BOS,11,8,32186,219,-3,NW
1961-07-22,0,BOS,11,9,25089,207,-2,NW
1961-07-23,0,BOS,4,5,28575,144,1,W
1961-07-28,0,BOS,3,8,15311,179,5,W
1961-07-30,1,BOS,4,2,0,140,-2,NW
1961-07-30,2,BOS,8,9,20996,190,1,W
1961-08-02,1,BOS,2,7,0,167,5,W
1961-08-02,2,BOS,7,8,11865,169,1,W
1961-08-03,0,BOS,0,4,12057,142,4,W
1961-08-04,0,BOS,5,0,8856,146,-5,NW
1961-08-05,0,BOS,4,10,6716,178,6,W
1961-08-06,1,BOS,2,4,0,165,2,W
1961-08-06,2,BOS,1,0,15008,154,-1,NW
1961-08-07,1,BOS,4,5,0,164,1,W
1961-08-07,2,BOS,4,5,11241,149,1,W
1961-08-08,0,BOS,6,5,17499,162,-1,NW
1961-08-09,0,BOS,4,5,12576,188,1,W
1961-08-10,0,BOS,2,3,8044,173,1,W
1961-08-22,0,BOS,2,3,15581,181,1,W
1961-08-23,0,BOS,4,9,5316,145,5,W
1961-08-24,0,BOS,4,5,4773,187,1,W
1961-09-04,0,BOS,7,2,12908,143,-5,NW
1961-09-05,0,BOS,9,5,14471,168,-4,NW
1961-09-06,0,BOS,4,9,4158,148,5,W
1961-09-07,0,BOS,4,8,4180,141,4,W
1961-09-08,0,BOS,2,9,18525,191,7,W
1961-09-09,0,BOS,3,1,12733,160,-2,NW
1961-09-10,0,BOS,7,8,14409,181,1,W
1961-09-15,0,BOS,2,3,10604,141,1,W
1961-09-16,0,BOS,5,4,7089,140,-1,NW
1961-09-17,0,BOS,0,1,9203,132,1,W
1961-09-23,0,BOS,8,3,28128,150,-5,NW
1961-09-24,0,BOS,1,3,30802,134,2,W
1961-09-26,1,BOS,7,5,0,137,-2,NW
1961-09-26,2,BOS,5,7,2979,131,2,W
1961-09-27,0,BOS,4,6,2412,158,2,W
1962-04-10,0,BOS,4,0,14736,137,-4,NW
1962-04-11,0,BOS,0,4,2466,165,4,W
1962-04-19,0,BOS,5,9,9223,180,4,W
1962-04-21,0,BOS,3,4,12558,128,1,W
1962-04-22,0,BOS,8,6,8011,175,-2,NW
1962-04-24,0,BOS,1,4,2749,135,3,W
1962-04-25,0,BOS,1,7,4536,126,6,W
1962-04-26,0,BOS,7,8,3662,189,1,W
1962-05-04,0,BOS,6,13,8782,181,7,W
1962-05-05,0,BOS,3,8,5688,160,5,W
1962-05-06,1,BOS,2,3,0,136,1,W
1962-05-06,2,BOS,5,3,16277,158,-2,NW
1962-05-15,0,BOS,4,14,19260,164,10,W
1962-05-16,0,BOS,9,8,16485,196,-1,NW
1962-05-17,0,BOS,2,1,9665,141,-1,NW
1962-05-18,0,BOS,8,4,10124,187,-4,NW
1962-05-19,0,BOS,6,5,6590,195,-1,NW
1962-05-20,1,BOS,5,3,0,184,-2,NW
1962-05-20,2,BOS,1,0,14356,124,-1,NW
1962-05-21,0,BOS,10,5,4937,161,-5,NW
1962-05-22,0,BOS,5,1,1424,135,-4,NW
1962-05-23,0,BOS,1,6,6051,161,5,W
1962-05-24,0,BOS,5,7,1124,160,2,W
1962-05-25,0,BOS,9,5,13487,181,-4,NW
1962-05-26,0,BOS,6,12,6279,155,6,W
1962-05-27,0,BOS,4,2,10954,186,-2,NW
1962-06-06,1,BOS,1,2,2110,127,1,W
1962-06-06,2,BOS,3,2,6351,200,-1,NW
1962-06-07,0,BOS,4,5,2586,170,1,W
1962-06-08,0,BOS,15,9,19341,288,-6,NW
1962-06-09,0,BOS,14,10,9386,180,-4,NW
1962-06-10,1,BOS,3,4,0,190,1,W
1962-06-10,2,BOS,9,3,21427,150,-6,NW
1962-06-11,0,BOS,10,0,2068,141,-10,NW
1962-06-12,0,BOS,3,4,6080,174,1,W
1962-06-13,0,BOS,0,4,4692,138,4,W
1962-06-14,0,BOS,7,4,2415,162,-3,NW
1962-06-26,0,BOS,0,2,14002,144,2,W
1962-06-27,0,BOS,3,0,5779,165,-3,NW
1962-06-28,0,BOS,19,7,3903,195,-12,NW
1962-06-29,0,BOS,3,9,11299,147,6,W
1962-06-30,0,BOS,6,12,5555,143,6,W
1962-07-01,0,BOS,9,5,19322,189,-4,NW
1962-07-02,0,BOS,3,4,12805,157,1,W
1962-07-03,0,BOS,4,3,7403,155,-1,NW
1962-07-04,1,BOS,8,4,0,146,-4,NW
1962-07-04,2,BOS,5,9,16910,162,4,W
1962-07-17,0,BOS,1,0,34386,138,-1,NW
1962-07-18,0,BOS,12,4,23885,172,-8,NW
1962-07-19,0,BOS,10,6,16253,162,-4,NW
1962-07-20,0,BOS,4,8,17998,141,4,W
1962-07-21,0,BOS,5,0,8408,140,-5,NW
1962-07-22,0,BOS,7,3,15621,191,-4,NW
1962-08-03,0,BOS,2,1,10112,130,-1,NW
1962-08-04,0,BOS,5,3,5328,165,-2,NW
1962-08-05,1,BOS,2,0,0,140,-2,NW
1962-08-05,2,BOS,4,5,13321,176,1,W
1962-08-06,0,BOS,5,2,9824,141,-3,NW
1962-08-07,0,BOS,3,1,5564,148,-2,NW
1962-08-08,0,BOS,0,6,13489,156,6,W
1962-08-09,0,BOS,0,4,3796,136,4,W
1962-08-11,1,BOS,0,3,5657,112,3,W
1962-08-11,2,BOS,3,7,8058,136,4,W
1962-08-12,0,BOS,1,4,5461,127,3,W
1962-08-27,0,BOS,4,7,11265,173,3,W
1962-08-31,0,BOS,5,7,14741,173,2,W
1962-09-01,0,BOS,4,5,7370,173,1,W
1962-09-02,0,BOS,5,2,9453,141,-3,NW
1962-09-03,1,BOS,8,5,0,177,-3,NW
1962-09-03,2,BOS,1,3,12953,112,2,W
1962-09-04,0,BOS,7,2,6212,163,-5,NW
1962-09-05,0,BOS,4,12,1217,136,8,W
1962-09-14,0,BOS,1,4,24370,168,3,W
1962-09-15,0,BOS,9,6,22280,184,-3,NW
1962-09-16,0,BOS,3,4,25048,158,1,W
1962-09-25,0,BOS,0,4,1224,110,4,W
1962-09-26,0,BOS,9,3,1212,166,-6,NW
1962-09-30,1,BOS,3,1,0,157,-2,NW
1962-09-30,2,BOS,1,3,6346,119,2,W
1963-04-16,0,BOS,1,6,26161,121,5,W
1963-04-17,0,BOS,5,4,8389,149,-1,NW
1963-04-19,1,BOS,1,3,13219,139,2,W
1963-04-19,2,BOS,1,5,12180,130,4,W
1963-04-20,0,BOS,3,4,7839,272,1,W
1963-04-21,0,BOS,5,2,15524,146,-3,NW
1963-04-27,0,BOS,5,9,5683,178,4,W
1963-04-28,1,BOS,3,4,0,219,1,W
1963-04-28,2,BOS,2,6,18412,122,4,W
1963-05-10,0,BOS,3,6,9025,157,3,W
1963-05-12,1,BOS,3,2,0,232,-1,NW
1963-05-12,2,BOS,1,4,13115,132,3,W
1963-05-13,0,BOS,5,8,5222,145,3,W
1963-05-15,1,BOS,3,9,0,156,6,W
1963-05-15,2,BOS,6,7,12789,144,1,W
1963-05-16,0,BOS,0,3,5261,136,3,W
1963-05-17,0,BOS,2,0,24118,148,-2,NW
1963-05-19,1,BOS,3,7,0,141,4,W
1963-05-19,2,BOS,9,7,24153,184,-2,NW
1963-05-20,0,BOS,6,5,5019,156,-1,NW
1963-05-21,0,BOS,8,2,11899,150,-6,NW
1963-05-22,0,BOS,3,1,3285,140,-2,NW
1963-05-28,0,BOS,6,11,23403,138,5,W
1963-05-30,0,BOS,6,5,26891,186,-1,NW
1963-06-12,0,BOS,3,5,6285,128,2,W
1963-06-13,0,BOS,5,7,3601,129,2,W
1963-06-14,0,BOS,1,5,18015,127,4,W
1963-06-16,1,BOS,1,8,0,126,7,W
1963-06-16,2,BOS,5,12,29258,173,7,W
1963-06-17,0,BOS,7,2,7219,137,-5,NW
1963-06-18,0,BOS,0,9,14130,156,9,W
1963-06-19,0,BOS,2,9,14795,143,7,W
1963-06-20,0,BOS,3,8,6173,145,5,W
1963-06-21,0,BOS,4,7,31120,135,3,W
1963-06-22,1,BOS,6,5,23859,168,-1,NW
1963-06-22,2,BOS,3,2,31217,136,-1,NW
1963-06-23,0,BOS,8,0,29402,126,-8,NW
1963-06-24,0,BOS,5,7,16950,149,2,W
1963-06-25,1,BOS,1,4,0,139,3,W
1963-06-25,2,BOS,2,3,18755,165,1,W
1963-06-26,0,BOS,5,6,11730,149,1,W
1963-06-27,0,BOS,6,4,6497,148,-2,NW
1963-07-05,0,BOS,3,8,23682,148,5,W
1963-07-06,0,BOS,2,6,19615,147,4,W
1963-07-07,0,BOS,4,1,17611,170,-3,NW
1963-07-23,0,BOS,1,0,13484,139,-1,NW
1963-07-24,1,BOS,5,2,0,140,-3,NW
1963-07-24,2,BOS,7,6,22989,160,-1,NW
1963-07-25,0,BOS,2,0,6283,118,-2,NW
1963-07-26,0,BOS,4,5,18866,150,1,W
1963-07-27,0,BOS,5,2,5863,170,-3,NW
1963-07-28,1,BOS,5,0,0,183,-5,NW
1963-07-28,2,BOS,5,4,17409,155,-1,NW
1963-07-29,0,BOS,5,7,10104,138,2,W
1963-07-30,0,BOS,6,3,15194,191,-3,NW
1963-07-31,0,BOS,9,5,7972,177,-4,NW
1963-08-14,1,BOS,7,14,20680,201,7,W
1963-08-14,2,BOS,4,5,24964,144,1,W
1963-08-15,0,BOS,10,2,18784,168,-8,NW
1963-08-16,0,BOS,4,7,16301,124,3,W
1963-08-17,0,BOS,3,10,9325,141,7,W
1963-08-18,0,BOS,7,4,14572,150,-3,NW
1963-08-19,0,BOS,8,3,11493,135,-5,NW
1963-08-20,0,BOS,10,2,11662,128,-8,NW
1963-08-21,0,BOS,7,1,12398,148,-6,NW
1963-08-22,0,BOS,2,11,7144,153,9,W
1963-08-30,0,BOS,7,0,6973,130,-7,NW
1963-08-31,0,BOS,4,5,6965,149,1,W
1963-09-01,0,BOS,3,4,15079,159,1,W
1963-09-02,1,BOS,3,4,0,123,1,W
1963-09-02,2,BOS,0,2,17288,134,2,W
1963-09-03,0,BOS,4,3,2896,149,-1,NW
1963-09-04,0,BOS,6,1,7750,169,-5,NW
1963-09-05,0,BOS,5,2,2312,127,-3,NW
1963-09-21,1,BOS,13,4,0,161,-9,NW
1963-09-21,2,BOS,2,11,6469,156,9,W
1963-09-22,0,BOS,6,1,6144,176,-5,NW
1963-09-24,0,BOS,1,5,674,139,4,W
1963-09-25,0,BOS,7,6,909,134,-1,NW
1963-09-28,0,BOS,3,4,2282,157,1,W
1964-04-17,0,BOS,1,4,20213,140,3,W
1964-04-18,0,BOS,10,5,9965,198,-5,NW
1964-04-19,0,BOS,6,0,9966,177,-6,NW
1964-04-20,0,BOS,0,4,15401,147,4,W
1964-04-28,0,BOS,4,6,2085,190,2,W
1964-04-29,0,BOS,4,2,1199,155,-2,NW
1964-05-02,0,BOS,4,0,8340,131,-4,NW
1964-05-03,0,BOS,7,11,11337,186,4,W
1964-05-04,0,BOS,7,5,12537,147,-2,NW
1964-05-05,0,BOS,0,4,2648,143,4,W
1964-05-15,0,BOS,1,0,18116,145,-1,NW
1964-05-16,0,BOS,5,6,8272,185,1,W
1964-05-17,1,BOS,2,6,0,170,4,W
1964-05-17,2,BOS,6,5,23504,175,-1,NW
1964-05-19,0,BOS,3,4,7027,177,1,W
1964-05-20,0,BOS,3,4,7704,153,1,W
1964-05-21,0,BOS,7,8,3585,182,1,W
1964-05-22,0,BOS,4,3,13728,150,-1,NW
1964-05-23,0,BOS,4,5,6119,170,1,W
1964-05-24,1,BOS,2,6,0,145,4,W
1964-05-24,2,BOS,1,3,15869,150,2,W
1964-05-25,0,BOS,5,6,6902,159,1,W
1964-05-26,0,BOS,2,3,10181,147,1,W
1964-05-27,0,BOS,9,8,3315,217,-1,NW
1964-06-09,0,BOS,2,5,31049,158,3,W
1964-06-10,1,BOS,6,7,10264,179,1,W
1964-06-10,2,BOS,10,6,28516,173,-4,NW
1964-06-11,0,BOS,8,4,28494,151,-4,NW
1964-06-12,0,BOS,3,7,19629,156,4,W
1964-06-13,0,BOS,2,6,7286,133,4,W
1964-06-14,1,BOS,10,1,0,168,-9,NW
1964-06-14,2,BOS,8,1,29853,151,-7,NW
1964-06-26,0,BOS,2,3,20495,128,1,W
1964-06-27,0,BOS,4,2,7352,167,-2,NW
1964-06-28,1,BOS,5,8,0,145,3,W
1964-06-28,2,BOS,3,4,20780,132,1,W
1964-06-29,0,BOS,3,4,21096,166,1,W
1964-06-30,0,BOS,2,1,4326,167,-1,NW
1964-07-01,0,BOS,14,3,13550,180,-11,NW
1964-07-02,0,BOS,15,9,5538,174,-6,NW
1964-07-03,0,BOS,5,3,8928,189,-2,NW
1964-07-04,0,BOS,5,13,7075,159,8,W
1964-07-05,0,BOS,6,9,14471,190,3,W
1964-07-14,0,BOS,4,2,14643,171,-2,NW
1964-07-15,0,BOS,2,11,12642,164,9,W
1964-07-16,0,BOS,9,3,8468,166,-6,NW
1964-07-17,0,BOS,0,5,10586,129,5,W
1964-07-18,0,BOS,6,12,4732,155,6,W
1964-07-19,1,BOS,10,11,0,188,1,W
1964-07-19,2,BOS,5,4,12324,185,-1,NW
1964-07-20,0,BOS,7,5,24247,172,-2,NW
1964-07-21,0,BOS,5,7,12515,149,2,W
1964-07-22,0,BOS,8,6,10330,161,-2,NW
1964-07-23,0,BOS,3,4,8187,182,1,W
1964-08-14,0,BOS,11,1,17143,158,-10,NW
1964-08-15,0,BOS,2,5,7807,154,3,W
1964-08-16,0,BOS,2,1,11593,141,-1,NW
1964-08-18,0,BOS,5,2,11765,127,-3,NW
1964-08-19,0,BOS,3,4,12699,193,1,W
1964-08-20,0,BOS,3,4,9331,135,1,W
1964-08-21,0,BOS,0,7,28830,135,7,W
1964-08-22,1,BOS,3,5,15663,170,2,W
1964-08-22,2,BOS,8,0,19958,146,-8,NW
1964-08-23,0,BOS,4,3,26518,159,-1,NW
1964-08-25,0,BOS,11,6,12692,168,-5,NW
1964-08-26,0,BOS,4,1,21989,158,-3,NW
1964-08-27,0,BOS,5,4,7440,162,-1,NW
1964-09-11,0,BOS,0,3,6772,136,3,W
1964-09-12,0,BOS,3,2,3718,192,-1,NW
1964-09-13,0,BOS,3,4,23840,173,1,W
1964-09-14,0,BOS,7,6,2056,189,-1,NW
1964-09-15,0,BOS,0,8,2776,147,8,W
1964-09-16,0,BOS,1,10,1287,148,9,W
1964-09-18,0,BOS,6,7,7608,211,1,W
1964-09-19,0,BOS,2,7,4146,151,5,W
1964-09-20,0,BOS,12,4,5964,202,-8,NW
1964-09-30,1,BOS,5,0,0,120,-5,NW
1964-09-30,2,BOS,3,0,934,130,-3,NW
1964-10-01,0,BOS,2,4,306,148,2,W
1964-10-03,0,BOS,0,7,1616,148,7,W
1964-10-04,0,BOS,8,14,3439,150,6,W
1965-04-17,0,BOS,9,12,18018,202,3,W
1965-04-18,0,BOS,4,11,6285,168,7,W
1965-04-20,0,BOS,2,5,6724,146,3,W
1965-04-21,0,BOS,3,1,10783,161,-2,NW
1965-05-07,0,BOS,5,1,9093,159,-4,NW
1965-05-08,0,BOS,8,15,20187,190,7,W
1965-05-09,1,BOS,9,4,0,156,-5,NW
1965-05-09,2,BOS,10,7,13852,166,-3,NW
1965-05-10,0,BOS,2,3,11163,117,1,W
1965-05-11,0,BOS,5,3,15444,150,-2,NW
1965-05-12,0,BOS,0,2,16593,120,2,W
1965-05-13,0,BOS,1,4,14261,137,3,W
1965-05-14,0,BOS,12,8,10271,205,-4,NW
1965-05-15,0,BOS,6,2,6514,170,-4,NW
1965-05-16,1,BOS,0,5,0,129,5,W
1965-05-16,2,BOS,3,4,18244,139,1,W
1965-05-25,0,BOS,17,5,9523,170,-12,NW
1965-05-26,0,BOS,9,7,9073,206,-2,NW
1965-05-27,0,BOS,0,2,3124,138,2,W
1965-05-28,0,BOS,3,9,9995,163,6,W
1965-05-30,0,BOS,2,3,10024,198,1,W
1965-05-31,1,BOS,5,3,0,150,-2,NW
1965-05-31,2,BOS,0,3,22031,140,3,W
1965-06-01,0,BOS,4,1,2121,151,-3,NW
1965-06-07,0,BOS,7,3,8276,155,-4,NW
1965-06-08,0,BOS,7,2,9704,155,-5,NW
1965-06-09,0,BOS,2,4,8475,125,2,W
1965-06-10,0,BOS,4,2,3464,134,-2,NW
1965-06-11,0,BOS,5,4,18849,148,-1,NW
1965-06-12,0,BOS,5,4,8864,155,-1,NW
1965-06-13,0,BOS,1,0,14452,126,-1,NW
1965-06-25,0,BOS,6,8,9287,175,2,W
1965-06-26,0,BOS,12,7,5718,187,-5,NW
1965-06-27,1,BOS,1,4,0,139,3,W
1965-06-27,2,BOS,4,5,10447,206,1,W
1965-06-28,0,BOS,9,2,12069,157,-7,NW
1965-06-29,0,BOS,8,5,8906,154,-3,NW
1965-07-01,0,BOS,2,1,3863,144,-1,NW
1965-07-02,0,BOS,16,2,20876,161,-14,NW
1965-07-03,0,BOS,6,2,8690,149,-4,NW
1965-07-04,0,BOS,3,5,17291,148,2,W
1965-07-21,1,BOS,8,6,0,207,-2,NW
1965-07-21,2,BOS,11,8,19761,177,-3,NW
1965-07-22,0,BOS,11,5,5922,154,-6,NW
1965-07-23,0,BOS,7,3,9398,146,-4,NW
1965-07-24,0,BOS,5,8,4778,165,3,W
1965-07-25,0,BOS,4,5,9049,166,1,W
1965-07-26,0,BOS,6,2,12604,172,-4,NW
1965-07-27,1,BOS,7,3,0,218,-4,NW
1965-07-27,2,BOS,10,8,6674,184,-2,NW
1965-07-28,0,BOS,0,6,5270,152,6,W
1965-07-29,0,BOS,4,6,3850,146,2,W
1965-08-10,1,BOS,5,15,0,156,10,W
1965-08-10,2,BOS,12,4,11316,177,-8,NW
1965-08-11,0,BOS,3,8,7480,151,5,W
1965-08-12,0,BOS,5,3,5912,152,-2,NW
1965-08-13,0,BOS,2,3,11065,145,1,W
1965-08-14,0,BOS,5,3,6839,176,-2,NW
1965-08-15,0,BOS,7,4,10230,165,-3,NW
1965-08-16,0,BOS,5,4,7259,166,-1,NW
1965-08-20,1,BOS,2,0,0,125,-2,NW
1965-08-20,2,BOS,3,2,11829,140,-1,NW
1965-08-21,0,BOS,10,13,7567,174,3,W
1965-08-22,0,BOS,2,1,7272,85,-1,NW
1965-08-24,1,BOS,4,9,0,152,5,W
1965-08-24,2,BOS,8,5,7072,176,-3,NW
1965-08-25,0,BOS,3,8,8467,142,5,W
1965-08-26,0,BOS,2,4,2049,132,2,W
1965-09-10,0,BOS,8,5,14636,193,-3,NW
1965-09-11,0,BOS,8,4,7564,172,-4,NW
1965-09-12,0,BOS,2,0,8688,120,-2,NW
1965-09-14,0,BOS,4,5,2811,227,1,W
1965-09-15,0,BOS,8,4,1900,147,-4,NW
1965-09-16,0,BOS,0,2,1247,120,2,W
1965-09-17,0,BOS,8,7,3589,165,-1,NW
1965-09-18,0,BOS,3,5,3115,142,2,W
1965-09-19,0,BOS,2,3,2891,135,1,W
1965-09-28,0,BOS,4,3,461,150,-1,NW
1965-09-29,0,BOS,1,2,409,138,1,W
1965-10-02,0,BOS,6,4,4300,140,-2,NW
1965-10-03,0,BOS,11,5,5933,150,-6,NW
1966-04-12,0,BOS,5,4,12386,225,-1,NW
1966-04-13,0,BOS,8,1,1955,162,-7,NW
1966-04-19,1,BOS,0,7,0,144,7,W
1966-04-19,2,BOS,6,4,25335,180,-2,NW
1966-04-20,0,BOS,3,5,2618,166,2,W
1966-04-23,0,BOS,5,4,6990,156,-1,NW
1966-04-27,0,BOS,8,6,1578,184,-2,NW
1966-04-30,0,BOS,16,9,14953,191,-7,NW
1966-05-01,1,BOS,6,1,0,169,-5,NW
1966-05-01,2,BOS,1,9,11228,146,8,W
1966-05-20,0,BOS,0,3,13192,136,3,W
1966-05-21,0,BOS,5,6,5557,176,1,W
1966-05-22,0,BOS,1,5,20540,136,4,W
1966-05-24,0,BOS,2,11,16867,147,9,W
1966-05-25,0,BOS,7,5,8809,187,-2,NW
1966-05-26,0,BOS,2,7,4831,138,5,W
1966-06-01,1,BOS,6,3,0,157,-3,NW
1966-06-01,2,BOS,0,5,8219,143,5,W
1966-06-02,0,BOS,12,2,2889,173,-10,NW
1966-06-03,0,BOS,15,5,27196,159,-10,NW
1966-06-04,0,BOS,3,6,21897,257,3,W
1966-06-05,0,BOS,5,3,21593,170,-2,NW
1966-06-15,0,BOS,11,7,8385,203,-4,NW
1966-06-16,0,BOS,16,4,4050,166,-12,NW
1966-06-17,0,BOS,5,3,15825,137,-2,NW
1966-06-18,0,BOS,16,6,7957,179,-10,NW
1966-06-19,1,BOS,5,3,0,176,-2,NW
1966-06-19,2,BOS,2,5,19350,135,3,W
1966-06-21,0,BOS,2,1,10115,150,-1,NW
1966-06-22,1,BOS,3,2,0,146,-1,NW
1966-06-22,2,BOS,5,6,10936,173,1,W
1966-06-23,0,BOS,8,6,5705,160,-2,NW
1966-06-24,0,BOS,1,5,14413,122,4,W
1966-06-25,0,BOS,4,3,2204,179,-1,NW
1966-06-26,1,BOS,7,13,0,144,6,W
1966-06-26,2,BOS,9,3,9474,174,-6,NW
1966-06-28,0,BOS,3,5,14922,121,2,W
1966-06-29,0,BOS,6,5,14614,160,-1,NW
1966-06-30,0,BOS,2,3,12727,169,1,W
1966-07-04,1,BOS,6,4,0,148,-2,NW
1966-07-04,2,BOS,0,1,8916,131,1,W
1966-07-08,1,BOS,1,3,0,120,2,W
1966-07-08,2,BOS,1,5,15747,141,4,W
1966-07-09,0,BOS,2,4,7134,142,2,W
1966-07-10,1,BOS,4,8,0,139,4,W
1966-07-10,2,BOS,6,10,16709,208,4,W
1966-07-20,1,BOS,1,6,0,132,5,W
1966-07-20,2,BOS,1,0,27391,156,-1,NW
1966-07-21,0,BOS,3,7,8176,163,4,W
1966-07-22,0,BOS,5,6,18078,210,1,W
1966-07-23,0,BOS,10,4,18365,171,-6,NW
1966-07-24,0,BOS,4,2,16421,173,-2,NW
1966-07-26,0,BOS,5,8,10958,171,3,W
1966-07-27,0,BOS,14,2,12638,156,-12,NW
1966-08-08,0,BOS,1,3,10003,153,2,W
1966-08-09,0,BOS,5,0,11174,133,-5,NW
1966-08-10,0,BOS,0,2,6125,179,2,W
1966-08-11,0,BOS,3,13,8160,166,10,W
1966-08-12,0,BOS,9,13,14663,200,4,W
1966-08-13,0,BOS,13,1,10003,161,-12,NW
1966-08-14,1,BOS,5,8,0,160,3,W
1966-08-14,2,BOS,3,5,20112,148,2,W
1966-08-15,0,BOS,4,2,10018,190,-2,NW
1966-08-16,0,BOS,6,4,17131,155,-2,NW
1966-08-17,0,BOS,8,4,15328,162,-4,NW
1966-08-19,0,BOS,2,1,15302,131,-1,NW
1966-08-20,0,BOS,4,2,11716,170,-2,NW
1966-08-21,0,BOS,4,6,11928,172,2,W
1966-08-24,1,BOS,4,2,0,149,-2,NW
1966-08-24,2,BOS,8,3,18666,140,-5,NW
1966-08-25,1,BOS,6,8,0,220,2,W
1966-08-25,2,BOS,1,4,8321,161,3,W
1966-09-09,0,BOS,2,1,17398,142,-1,NW
1966-09-10,0,BOS,5,1,21018,164,-4,NW
1966-09-11,0,BOS,4,2,15482,199,-2,NW
1966-09-13,0,BOS,1,10,5020,161,9,W
1966-09-14,0,BOS,1,2,1003,135,1,W
1966-09-15,0,BOS,4,5,1010,158,1,W
1966-09-16,0,BOS,4,5,5669,148,1,W
1966-09-17,0,BOS,1,3,4472,142,2,W
1966-09-18,0,BOS,5,3,15632,179,-2,NW
1967-04-12,0,BOS,4,5,8324,194,1,W
1967-04-13,0,BOS,8,5,3607,180,-3,NW
1967-04-21,0,BOS,1,6,25603,135,5,W
1967-04-22,0,BOS,4,5,8189,180,1,W
1967-04-23,0,BOS,7,5,18041,187,-2,NW
1967-04-28,0,BOS,0,3,9026,148,3,W
1967-04-29,0,BOS,10,11,9724,277,1,W
1967-04-30,0,BOS,1,0,31450,144,-1,NW
1967-05-12,0,BOS,5,4,15564,164,-1,NW
1967-05-13,0,BOS,10,8,9606,193,-2,NW
1967-05-14,1,BOS,5,8,0,149,3,W
1967-05-14,2,BOS,9,13,16436,183,4,W
1967-05-16,0,BOS,8,5,9510,171,-3,NW
1967-05-17,0,BOS,12,8,8714,163,-4,NW
1967-05-19,0,BOS,2,3,15354,151,1,W
1967-05-20,0,BOS,5,3,8994,181,-2,NW
1967-05-21,1,BOS,3,4,0,140,1,W
1967-05-21,2,BOS,2,6,24976,148,4,W
1967-05-30,1,BOS,4,5,0,165,1,W
1967-05-30,2,BOS,1,6,32012,126,5,W
1967-05-31,0,BOS,2,3,12335,131,1,W
1967-06-01,0,BOS,4,0,12233,129,-4,NW
1967-06-09,0,BOS,7,8,25326,155,1,W
1967-06-10,0,BOS,7,3,15634,170,-4,NW
1967-06-11,1,BOS,3,4,0,154,1,W
1967-06-11,2,BOS,8,7,16599,178,-1,NW
1967-06-12,0,BOS,1,3,18939,130,2,W
1967-06-13,0,BOS,5,3,17190,160,-2,NW
1967-06-14,1,BOS,8,7,0,183,-1,NW
1967-06-14,2,BOS,1,6,22178,150,5,W
1967-06-15,0,BOS,1,2,16775,202,1,W
1967-06-23,0,BOS,4,8,30233,175,4,W
1967-06-24,0,BOS,3,2,30027,175,-1,NW
1967-06-25,0,BOS,3,8,23719,165,5,W
1967-07-13,1,BOS,2,4,19171,144,2,W
1967-07-13,2,BOS,10,0,23111,174,-10,NW
1967-07-14,0,BOS,5,11,27787,157,6,W
1967-07-15,0,BOS,1,5,16025,140,4,W
1967-07-16,0,BOS,5,9,28237,148,4,W
1967-07-17,0,BOS,1,7,28991,128,6,W
1967-07-25,0,BOS,6,4,21527,190,-2,NW
1967-07-26,0,BOS,6,9,32403,160,3,W
1967-07-27,0,BOS,5,6,34193,158,1,W
1967-07-28,0,BOS,9,2,33075,140,-7,NW
1967-07-29,1,BOS,3,6,0,155,3,W
1967-07-29,2,BOS,10,3,35469,159,-7,NW
1967-07-30,0,BOS,7,5,24459,165,-2,NW
1967-07-31,0,BOS,0,4,22605,135,4,W
1967-08-01,1,BOS,4,3,0,140,-1,NW
1967-08-01,2,BOS,3,8,26750,189,5,W
1967-08-02,0,BOS,8,6,24581,180,-2,NW
1967-08-03,0,BOS,3,5,18920,168,2,W
1967-08-15,0,BOS,0,4,27125,128,4,W
1967-08-16,0,BOS,3,8,32051,163,5,W
1967-08-17,0,BOS,7,4,28653,200,-3,NW
1967-08-18,0,BOS,2,3,31027,136,1,W
1967-08-19,0,BOS,11,12,24117,215,1,W
1967-08-20,1,BOS,2,12,0,194,10,W
1967-08-20,2,BOS,8,9,33840,199,1,W
1967-08-21,0,BOS,5,6,26018,165,1,W
1967-08-22,1,BOS,1,2,0,139,1,W
1967-08-22,2,BOS,3,5,30994,156,2,W
1967-08-23,0,BOS,3,2,33680,155,-1,NW
1967-08-24,0,BOS,5,7,31283,175,2,W
1967-08-31,0,BOS,4,2,35138,154,-2,NW
1967-09-01,0,BOS,2,10,34054,150,8,W
1967-09-02,0,BOS,4,1,28222,166,-3,NW
1967-09-03,0,BOS,4,0,29818,148,-4,NW
1967-09-07,0,BOS,1,3,28738,127,2,W
1967-09-08,0,BOS,5,2,33534,155,-3,NW
1967-09-09,0,BOS,1,7,32119,157,6,W
1967-09-10,0,BOS,1,9,26341,157,8,W
1967-09-12,0,BOS,1,3,27976,128,2,W
1967-09-13,0,BOS,2,4,12257,157,2,W
1967-09-15,0,BOS,6,2,32489,160,-4,NW
1967-09-16,0,BOS,4,1,27219,142,-3,NW
1967-09-17,0,BOS,5,2,30301,147,-3,NW
1967-09-26,0,BOS,6,3,16652,149,-3,NW
1967-09-27,0,BOS,6,0,18415,159,-6,NW
1967-09-30,0,BOS,4,6,32909,183,2,W
1967-10-01,0,BOS,3,5,35770,145,2,W
1968-04-16,0,BOS,9,2,32849,188,-7,NW
1968-04-17,0,BOS,0,2,19655,135,2,W
1968-04-18,0,BOS,0,3,20474,144,3,W
1968-04-19,0,BOS,2,9,34863,195,7,W
1968-04-20,0,BOS,2,3,28955,156,1,W
1968-04-21,0,BOS,7,0,19814,211,-7,NW
1968-04-29,0,BOS,11,2,26256,148,-9,NW
1968-04-30,0,BOS,7,6,7310,171,-1,NW
1968-05-01,0,BOS,5,3,12001,175,-2,NW
1968-05-02,0,BOS,1,4,4699,150,3,W
1968-05-03,0,BOS,7,2,23562,148,-5,NW
1968-05-04,0,BOS,4,2,21967,183,-2,NW
1968-05-05,0,BOS,3,2,29460,171,-1,NW
1968-05-14,0,BOS,4,5,19439,160,1,W
1968-05-15,0,BOS,4,6,10953,140,2,W
1968-05-16,0,BOS,10,11,22879,175,1,W
1968-05-17,0,BOS,4,6,35253,145,2,W
1968-05-18,0,BOS,0,4,32889,157,4,W
1968-05-19,0,BOS,11,3,34727,170,-8,NW
1968-05-31,0,BOS,0,3,29301,133,3,W
1968-06-01,0,BOS,1,5,25608,131,4,W
1968-06-02,0,BOS,4,3,34053,114,-1,NW
1968-06-03,0,BOS,3,4,17552,181,1,W
1968-06-04,1,BOS,0,2,0,138,2,W
1968-06-04,2,BOS,2,0,31698,137,-2,NW
1968-06-05,0,BOS,5,4,22385,166,-1,NW
1968-06-06,0,BOS,5,3,16513,132,-2,NW
1968-06-07,0,BOS,2,3,30058,142,1,W
1968-06-08,0,BOS,4,0,24287,151,-4,NW
1968-06-13,1,BOS,4,2,0,191,-2,NW
1968-06-13,2,BOS,1,5,15112,143,4,W
1968-06-27,0,BOS,3,9,21062,190,6,W
1968-06-29,1,BOS,8,1,22263,170,-7,NW
1968-06-29,2,BOS,4,1,25078,155,-3,NW
1968-06-30,0,BOS,7,5,27289,224,-2,NW
1968-07-01,0,BOS,0,3,27595,158,3,W
1968-07-02,0,BOS,3,4,21492,153,1,W
1968-07-03,0,BOS,3,4,18714,208,1,W
1968-07-04,0,BOS,2,7,14332,166,5,W
1968-07-05,0,BOS,2,4,33278,146,2,W
1968-07-06,0,BOS,2,4,24617,151,2,W
1968-07-07,1,BOS,3,4,0,137,1,W
1968-07-07,2,BOS,3,6,33486,158,3,W
1968-07-19,0,BOS,7,3,29172,159,-4,NW
1968-07-20,0,BOS,2,7,25245,155,5,W
1968-07-21,1,BOS,3,4,0,147,1,W
1968-07-21,2,BOS,4,3,32391,167,-1,NW
1968-07-29,1,BOS,2,3,20539,172,1,W
1968-07-29,2,BOS,3,8,28328,164,5,W
1968-07-30,0,BOS,8,3,33136,173,-5,NW
1968-07-31,0,BOS,7,3,33789,165,-4,NW
1968-08-01,0,BOS,1,0,24672,126,-1,NW
1968-08-02,1,BOS,3,2,0,144,-1,NW
1968-08-02,2,BOS,1,6,30462,149,5,W
1968-08-03,1,BOS,3,8,23929,139,5,W
1968-08-03,2,BOS,3,5,26195,177,2,W
1968-08-04,0,BOS,12,6,27182,180,-6,NW
1968-08-12,0,BOS,1,2,23235,138,1,W
1968-08-13,0,BOS,3,4,23648,134,1,W
1968-08-14,1,BOS,5,3,26469,155,-2,NW
1968-08-14,2,BOS,5,7,21402,162,2,W
1968-08-15,0,BOS,0,3,21260,122,3,W
1968-08-16,0,BOS,4,0,35323,156,-4,NW
1968-08-17,0,BOS,10,9,28778,233,-1,NW
1968-08-18,0,BOS,1,4,31428,142,3,W
1968-08-26,0,BOS,0,3,30926,139,3,W
1968-08-27,0,BOS,1,7,29018,143,6,W
1968-08-28,0,BOS,5,3,25865,160,-2,NW
1968-08-29,0,BOS,2,11,19101,150,9,W
1968-08-30,0,BOS,5,1,25854,170,-4,NW
1968-08-31,0,BOS,4,6,21599,155,2,W
1968-09-01,0,BOS,4,7,23910,143,3,W
1968-09-13,0,BOS,0,3,23171,100,3,W
1968-09-14,0,BOS,7,3,22530,147,-4,NW
1968-09-15,0,BOS,3,2,26983,142,-1,NW
1968-09-16,0,BOS,8,1,17357,193,-7,NW
1968-09-17,0,BOS,0,2,17523,143,2,W
1968-09-18,0,BOS,0,4,8918,161,4,W
1968-09-27,0,BOS,2,12,28796,156,10,W
1968-09-28,0,BOS,4,3,25534,147,-1,NW
1968-09-29,0,BOS,4,3,35209,142,-1,NW
1969-04-14,0,BOS,3,5,33899,150,2,W
1969-04-15,0,BOS,10,5,9673,170,-5,NW
1969-04-16,0,BOS,11,8,8328,165,-3,NW
1969-04-17,0,BOS,9,5,8910,164,-4,NW
1969-04-18,0,BOS,7,10,7232,177,3,W
1969-04-20,0,BOS,4,9,29074,190,5,W
1969-04-21,0,BOS,6,4,35190,180,-2,NW
1969-04-22,0,BOS,3,8,15469,130,5,W
1969-04-23,0,BOS,9,3,28972,173,-6,NW
1969-05-02,0,BOS,2,3,35894,144,1,W
1969-05-03,0,BOS,5,7,26017,172,2,W
1969-05-04,0,BOS,2,4,33515,184,2,W
1969-05-16,0,BOS,10,9,33709,229,-1,NW
1969-05-17,0,BOS,1,6,21172,144,5,W
1969-05-18,0,BOS,9,6,25125,188,-3,NW
1969-05-21,1,BOS,2,5,0,151,3,W
1969-05-21,2,BOS,3,8,25439,161,5,W
1969-05-22,0,BOS,3,4,14238,166,1,W
1969-05-30,0,BOS,2,3,35434,170,1,W
1969-05-31,0,BOS,10,4,25540,174,-6,NW
1969-06-01,0,BOS,2,5,29207,143,3,W
1969-06-02,0,BOS,6,4,21265,142,-2,NW
1969-06-03,0,BOS,2,8,21481,159,6,W
1969-06-04,0,BOS,7,2,23721,150,-5,NW
1969-06-06,0,BOS,2,4,29438,146,2,W
1969-06-07,0,BOS,0,4,24717,144,4,W
1969-06-08,0,BOS,2,8,32897,127,6,W
1969-06-13,0,BOS,4,1,33745,180,-3,NW
1969-06-14,0,BOS,21,7,22395,203,-14,NW
1969-06-15,0,BOS,13,5,25733,181,-8,NW
1969-06-21,1,BOS,5,6,12453,215,1,W
1969-06-21,2,BOS,6,3,30571,177,-3,NW
1969-06-22,0,BOS,5,3,29901,182,-2,NW
1969-06-24,1,BOS,6,3,18447,162,-3,NW
1969-06-24,2,BOS,1,6,26862,148,5,W
1969-06-25,1,BOS,1,3,0,169,2,W
1969-06-25,2,BOS,7,3,30401,170,-4,NW
1969-06-26,0,BOS,3,4,25799,168,1,W
1969-07-04,1,BOS,5,1,0,165,-4,NW
1969-07-04,2,BOS,4,7,24927,170,3,W
1969-07-05,1,BOS,6,2,20869,130,-4,NW
1969-07-05,2,BOS,4,11,24040,178,7,W
1969-07-06,0,BOS,5,0,23862,169,-5,NW
1969-07-07,0,BOS,2,7,26020,144,5,W
1969-07-08,0,BOS,1,4,32523,131,3,W
1969-07-09,0,BOS,6,5,34650,169,-1,NW
1969-07-18,0,BOS,1,6,31607,138,5,W
1969-07-19,0,BOS,3,5,32947,145,2,W
1969-07-20,0,BOS,5,6,31174,169,1,W
1969-08-05,0,BOS,9,2,25977,161,-7,NW
1969-08-06,0,BOS,6,5,22186,205,-1,NW
1969-08-07,0,BOS,4,5,30706,163,1,W
1969-08-08,0,BOS,7,6,28608,201,-1,NW
1969-08-09,0,BOS,4,9,23832,168,5,W
1969-08-10,0,BOS,9,1,25996,156,-8,NW
1969-08-18,0,BOS,6,7,28062,194,1,W
1969-08-19,0,BOS,8,6,29296,182,-2,NW
1969-08-20,0,BOS,6,7,30003,184,1,W
1969-08-22,0,BOS,4,1,27402,141,-3,NW
1969-08-23,0,BOS,0,2,23922,121,2,W
1969-08-24,0,BOS,3,1,25615,129,-2,NW
1969-08-26,0,BOS,1,4,21523,143,3,W
1969-08-27,0,BOS,3,4,20717,145,1,W
1969-08-28,0,BOS,8,9,23359,199,1,W
1969-09-01,0,BOS,2,6,22930,160,4,W
1969-09-03,1,BOS,7,4,0,150,-3,NW
1969-09-03,2,BOS,1,5,10681,138,4,W
1969-09-05,0,BOS,8,9,25976,191,1,W
1969-09-06,0,BOS,5,9,22121,179,4,W
1969-09-07,0,BOS,3,2,24880,151,-1,NW
1969-09-15,0,BOS,4,1,15829,138,-3,NW
1969-09-16,0,BOS,5,2,16579,131,-3,NW
1969-09-18,1,BOS,6,4,0,160,-2,NW
1969-09-18,2,BOS,0,5,20430,138,5,W
1969-09-22,0,BOS,3,4,12961,141,1,W
1969-09-23,0,BOS,3,8,14491,149,5,W
1969-09-24,0,BOS,0,1,13614,203,1,W
1969-09-25,0,BOS,3,4,5371,139,1,W
1969-09-26,0,BOS,5,6,20820,172,1,W
1969-09-27,0,BOS,2,1,22459,122,-1,NW
1969-09-28,0,BOS,10,3,26621,160,-7,NW
1970-04-14,0,BOS,3,8,34002,150,5,W
1970-04-15,0,BOS,2,6,7906,135,4,W
1970-04-16,0,BOS,5,8,8217,160,3,W
1970-04-20,0,BOS,3,2,29000,99,-1,NW
1970-04-22,0,BOS,2,5,25660,154,3,W
1970-04-25,1,BOS,10,4,0,163,-6,NW
1970-04-25,2,BOS,0,3,22004,124,3,W
1970-04-26,0,BOS,5,3,19811,144,-2,NW
1970-04-27,0,BOS,3,4,5085,119,1,W
1970-04-28,0,BOS,1,2,14941,124,1,W
1970-04-29,0,BOS,3,5,14297,174,2,W
1970-04-30,0,BOS,7,8,6225,139,1,W
1970-05-01,0,BOS,3,8,23292,139,5,W
1970-05-02,0,BOS,8,4,26144,176,-4,NW
1970-05-15,0,BOS,3,0,23102,117,-3,NW
1970-05-16,0,BOS,2,6,19485,130,4,W
1970-05-19,0,BOS,4,5,18415,193,1,W
1970-05-25,0,BOS,3,5,14825,162,2,W
1970-05-26,0,BOS,7,5,12647,130,-2,NW
1970-05-27,0,BOS,7,5,16867,162,-2,NW
1970-05-29,0,BOS,3,4,22737,151,1,W
1970-05-30,0,BOS,5,7,21026,154,2,W
1970-05-31,0,BOS,22,13,21952,206,-9,NW
1970-06-02,0,BOS,1,5,19080,157,4,W
1970-06-04,0,BOS,1,5,19098,148,4,W
1970-06-05,0,BOS,2,4,19412,150,2,W
1970-06-07,1,BOS,4,7,0,175,3,W
1970-06-07,2,BOS,2,5,30434,150,3,W
1970-06-18,0,BOS,3,2,26305,145,-1,NW
1970-06-19,0,BOS,4,7,32311,142,3,W
1970-06-20,0,BOS,8,3,30789,148,-5,NW
1970-06-21,0,BOS,14,10,31073,234,-4,NW
1970-06-22,0,BOS,9,8,22676,187,-1,NW
1970-06-23,0,BOS,1,5,23798,134,4,W
1970-06-24,0,BOS,5,6,25003,175,1,W
1970-06-25,0,BOS,13,8,20548,300,-5,NW
1970-06-30,0,BOS,3,1,19797,146,-2,NW
1970-07-01,0,BOS,5,6,22218,164,1,W
1970-07-02,0,BOS,0,5,15593,139,5,W
1970-07-03,1,BOS,1,2,0,132,1,W
1970-07-03,2,BOS,4,5,27395,177,1,W
1970-07-04,0,BOS,1,5,14246,144,4,W
1970-07-05,0,BOS,4,8,21690,159,4,W
1970-07-16,0,BOS,5,6,20484,179,1,W
1970-07-17,0,BOS,2,8,27114,179,6,W
1970-07-18,0,BOS,10,5,22723,168,-5,NW
1970-07-19,0,BOS,4,9,28464,136,5,W
1970-07-20,0,BOS,3,2,22888,157,-1,NW
1970-07-21,0,BOS,10,6,21194,171,-4,NW
1970-07-22,1,BOS,4,7,28996,167,3,W
1970-07-22,2,BOS,3,8,23916,163,5,W
1970-07-23,0,BOS,4,1,25658,181,-3,NW
1970-08-08,0,BOS,6,5,32551,155,-1,NW
1970-08-09,0,BOS,4,7,27188,141,3,W
1970-08-10,0,BOS,10,11,21959,177,1,W
1970-08-12,1,BOS,4,7,0,144,3,W
1970-08-12,2,BOS,4,3,23450,153,-1,NW
1970-08-13,0,BOS,11,3,17252,165,-8,NW
1970-08-14,0,BOS,1,8,27962,150,7,W
1970-08-15,1,BOS,3,5,25270,152,2,W
1970-08-15,2,BOS,7,11,23277,185,4,W
1970-08-16,0,BOS,9,6,24670,179,-3,NW
1970-08-17,0,BOS,2,7,12658,146,5,W
1970-08-18,0,BOS,4,8,25592,160,4,W
1970-08-19,0,BOS,13,5,17113,152,-8,NW
1970-08-31,0,BOS,2,4,22339,150,2,W
1970-09-01,0,BOS,10,9,18794,180,-1,NW
1970-09-02,1,BOS,6,4,14704,163,-2,NW
1970-09-02,2,BOS,1,10,18938,169,9,W
1970-09-03,0,BOS,2,5,14998,133,3,W
1970-09-04,0,BOS,8,6,22735,176,-2,NW
1970-09-05,0,BOS,3,2,18790,141,-1,NW
1970-09-06,0,BOS,8,9,24580,214,1,W
1970-09-19,1,BOS,3,7,17285,140,4,W
1970-09-19,2,BOS,3,11,14858,152,8,W
1970-09-20,0,BOS,1,3,21275,114,2,W
1970-09-21,0,BOS,1,2,10010,154,1,W
1970-09-22,0,BOS,2,8,11959,145,6,W
1970-09-23,0,BOS,5,2,3334,155,-3,NW
1970-09-29,0,BOS,4,5,14254,160,1,W
1970-09-30,0,BOS,4,3,16255,131,-1,NW
1971-04-06,0,BOS,1,3,34517,139,2,W
1971-04-19,0,BOS,5,4,20453,234,-1,NW
1971-04-20,0,BOS,1,4,11416,140,3,W
1971-04-21,0,BOS,7,9,12524,156,2,W
1971-04-23,0,BOS,1,7,12261,130,6,W
1971-04-24,0,BOS,2,4,17386,140,2,W
1971-04-25,0,BOS,4,5,13112,163,1,W
1971-04-27,0,BOS,4,2,11361,158,-2,NW
1971-04-28,0,BOS,3,10,4437,143,7,W
1971-04-30,0,BOS,3,4,18108,148,1,W
1971-05-01,0,BOS,7,3,16494,145,-4,NW
1971-05-02,1,BOS,0,1,0,109,1,W
1971-05-02,2,BOS,8,9,23163,215,1,W
1971-05-14,0,BOS,0,2,33941,129,2,W
1971-05-15,0,BOS,7,4,28480,181,-3,NW
1971-05-17,0,BOS,2,3,14001,165,1,W
1971-05-18,0,BOS,3,5,13021,151,2,W
1971-05-19,0,BOS,2,7,21077,164,5,W
1971-05-20,0,BOS,2,5,20334,127,3,W
1971-05-24,0,BOS,8,6,14331,158,-2,NW
1971-05-25,0,BOS,6,5,13760,189,-1,NW
1971-05-26,0,BOS,2,3,13526,121,1,W
1971-05-27,0,BOS,2,6,14995,146,4,W
1971-05-28,0,BOS,3,4,35714,135,1,W
1971-05-29,0,BOS,12,8,22572,191,-4,NW
1971-05-31,1,BOS,7,3,0,158,-4,NW
1971-05-31,2,BOS,9,4,31110,154,-5,NW
1971-06-01,0,BOS,4,2,9186,128,-2,NW
1971-06-04,0,BOS,1,10,31375,153,9,W
1971-06-05,0,BOS,3,2,25764,120,-1,NW
1971-06-06,0,BOS,5,2,28853,158,-3,NW
1971-06-22,1,BOS,9,3,0,153,-6,NW
1971-06-22,2,BOS,0,2,25578,124,2,W
1971-06-23,0,BOS,1,2,17513,127,1,W
1971-06-25,0,BOS,7,3,31505,131,-4,NW
1971-06-26,1,BOS,2,3,27298,140,1,W
1971-06-26,2,BOS,2,10,24531,141,8,W
1971-06-27,0,BOS,1,3,29362,124,2,W
1971-06-28,0,BOS,4,10,21000,163,6,W
1971-06-29,0,BOS,2,6,25024,146,4,W
1971-07-02,0,BOS,6,0,29309,142,-6,NW
1971-07-03,0,BOS,2,1,28878,125,-1,NW
1971-07-04,0,BOS,4,7,23108,159,3,W
1971-07-05,0,BOS,7,12,23364,167,5,W
1971-07-15,0,BOS,0,3,27673,219,3,W
1971-07-16,0,BOS,4,9,29293,148,5,W
1971-07-17,1,BOS,11,13,28645,164,2,W
1971-07-17,2,BOS,3,5,27791,96,2,W
1971-07-18,0,BOS,5,4,22602,148,-1,NW
1971-07-20,0,BOS,4,5,23373,169,1,W
1971-07-21,0,BOS,1,6,24946,138,5,W
1971-07-22,0,BOS,4,2,28268,153,-2,NW
1971-08-05,0,BOS,4,5,27778,175,1,W
1971-08-06,0,BOS,2,0,32108,131,-2,NW
1971-08-07,0,BOS,12,8,25857,196,-4,NW
1971-08-08,0,BOS,8,2,32146,168,-6,NW
1971-08-09,0,BOS,11,12,20116,191,1,W
1971-08-10,1,BOS,6,5,24202,158,-1,NW
1971-08-10,2,BOS,7,5,30004,161,-2,NW
1971-08-11,0,BOS,5,3,30481,178,-2,NW
1971-08-12,0,BOS,9,2,23827,162,-7,NW
1971-08-13,0,BOS,5,1,22700,127,-4,NW
1971-08-14,0,BOS,6,1,21325,189,-5,NW
1971-08-15,0,BOS,5,1,22453,131,-4,NW
1971-08-16,0,BOS,5,6,17877,137,1,W
1971-08-17,0,BOS,4,3,19953,138,-1,NW
1971-08-18,0,BOS,3,4,25507,133,1,W
1971-08-31,0,BOS,3,4,26040,145,1,W
1971-09-01,0,BOS,8,2,23676,131,-6,NW
1971-09-02,0,BOS,0,3,19676,131,3,W
1971-09-03,0,BOS,2,9,16086,151,7,W
1971-09-04,0,BOS,11,9,16506,167,-2,NW
1971-09-05,0,BOS,1,8,22820,118,7,W
1971-09-13,0,BOS,4,0,12272,165,-4,NW
1971-09-14,0,BOS,6,3,12492,134,-3,NW
1971-09-21,0,BOS,2,3,11323,139,1,W
1971-09-22,0,BOS,2,3,10554,127,1,W
1971-09-24,0,BOS,0,4,14351,148,4,W
1971-09-25,0,BOS,3,6,19126,137,3,W
1971-09-26,0,BOS,1,8,15240,155,7,W
1972-04-17,0,BOS,4,0,24989,137,-4,NW
1972-04-18,0,BOS,2,4,8231,172,2,W
1972-04-19,0,BOS,3,1,9735,147,-2,NW
1972-04-21,0,BOS,4,5,14895,155,1,W
1972-04-22,0,BOS,7,11,11162,171,4,W
1972-05-05,0,BOS,5,2,13208,155,-3,NW
1972-05-06,0,BOS,3,2,13799,158,-1,NW
1972-05-07,0,BOS,8,4,11747,172,-4,NW
1972-05-23,0,BOS,5,6,14552,187,1,W
1972-05-24,0,BOS,4,1,14384,159,-3,NW
1972-05-25,0,BOS,1,2,12291,140,1,W
1972-05-26,0,BOS,4,5,16340,164,1,W
1972-05-27,0,BOS,3,9,17332,166,6,W
1972-05-28,0,BOS,1,4,18356,123,3,W
1972-05-29,0,BOS,11,3,15486,157,-8,NW
1972-06-09,0,BOS,5,6,16757,104,1,W
1972-06-10,0,BOS,7,3,21682,164,-4,NW
1972-06-11,0,BOS,4,8,15821,172,4,W
1972-06-13,0,BOS,4,2,12121,161,-2,NW
1972-06-14,0,BOS,3,11,10696,154,8,W
1972-06-15,0,BOS,13,9,11127,170,-4,NW
1972-06-17,1,BOS,5,4,14638,148,-1,NW
1972-06-17,2,BOS,8,10,11446,175,2,W
1972-06-18,0,BOS,8,4,19311,154,-4,NW
1972-06-19,0,BOS,0,12,8860,157,12,W
1972-06-20,0,BOS,5,2,12864,165,-3,NW
1972-06-21,0,BOS,9,10,15325,204,1,W
1972-06-28,0,BOS,3,5,16822,177,2,W
1972-06-29,0,BOS,8,4,17775,169,-4,NW
1972-07-01,0,BOS,4,5,17691,151,1,W
1972-07-02,1,BOS,4,15,0,140,11,W
1972-07-02,2,BOS,2,3,20478,173,1,W
1972-07-03,0,BOS,2,8,13460,137,6,W
1972-07-04,0,BOS,0,2,16356,119,2,W
1972-07-05,0,BOS,0,2,12641,132,2,W
1972-07-17,0,BOS,1,4,13793,138,3,W
1972-07-18,0,BOS,1,4,15472,121,3,W
1972-07-19,0,BOS,2,8,24794,148,6,W
1972-07-20,1,BOS,1,2,0,141,1,W
1972-07-20,2,BOS,3,4,33657,176,1,W
1972-07-21,0,BOS,4,5,27465,259,1,W
1972-07-22,1,BOS,5,3,26067,162,-2,NW
1972-07-22,2,BOS,0,3,33279,135,3,W
1972-07-23,0,BOS,6,3,28481,149,-3,NW
1972-08-01,0,BOS,10,4,23070,179,-6,NW
1972-08-02,1,BOS,5,1,16491,136,-4,NW
1972-08-02,2,BOS,4,7,21917,142,3,W
1972-08-03,0,BOS,2,7,18065,167,5,W
1972-08-04,0,BOS,0,2,31852,143,2,W
1972-08-05,0,BOS,3,6,25735,135,3,W
1972-08-06,0,BOS,11,2,28976,149,-9,NW
1972-08-07,0,BOS,6,2,10137,167,-4,NW
1972-08-08,0,BOS,1,4,19651,138,3,W
1972-08-09,0,BOS,2,5,23511,159,3,W
1972-08-25,0,BOS,0,4,33551,161,4,W
1972-08-26,0,BOS,6,7,18107,154,1,W
1972-08-27,0,BOS,3,10,17755,165,7,W
1972-08-28,0,BOS,6,4,24007,192,-2,NW
1972-08-29,0,BOS,0,3,23601,142,3,W
1972-08-30,0,BOS,2,4,26062,126,2,W
1972-09-01,0,BOS,0,1,18990,153,1,W
1972-09-02,0,BOS,3,5,11495,161,2,W
1972-09-06,0,BOS,0,2,18235,150,2,W
1972-09-07,0,BOS,4,10,24661,161,6,W
1972-09-08,0,BOS,2,4,28462,135,2,W
1972-09-15,0,BOS,3,4,19880,166,1,W
1972-09-16,0,BOS,0,10,17335,158,10,W
1972-09-17,0,BOS,9,2,21502,163,-7,NW
1972-09-18,0,BOS,5,2,17803,186,-3,NW
1972-09-20,1,BOS,1,9,0,159,8,W
1972-09-20,2,BOS,0,4,28777,157,4,W
1972-09-21,0,BOS,10,3,20492,181,-7,NW
1972-09-22,0,BOS,2,3,34632,146,1,W
1972-09-23,0,BOS,7,1,30407,148,-6,NW
1972-09-24,0,BOS,2,7,34182,163,5,W
1972-09-26,0,BOS,6,4,20669,150,-2,NW
1972-09-27,0,BOS,5,7,8744,157,2,W
1972-09-28,0,BOS,1,3,10196,130,2,W
1973-04-06,0,BOS,5,15,32882,177,10,W
1973-04-07,0,BOS,5,10,19236,151,5,W
1973-04-08,0,BOS,3,4,12754,137,1,W
1973-04-16,0,BOS,9,7,29006,174,-2,NW
1973-04-17,0,BOS,6,3,11298,157,-3,NW
1973-04-18,0,BOS,7,1,15971,156,-6,NW
1973-04-19,0,BOS,11,7,13572,187,-4,NW
1973-04-24,0,BOS,6,4,10859,190,-2,NW
1973-04-25,0,BOS,3,4,9529,162,1,W
1973-04-28,0,BOS,2,1,18888,191,-1,NW
1973-04-29,0,BOS,5,0,11617,139,-5,NW
1973-05-01,0,BOS,7,6,8616,175,-1,NW
1973-05-02,0,BOS,2,6,8247,134,4,W
1973-05-10,0,BOS,3,4,8640,142,1,W
1973-05-11,0,BOS,2,4,12803,161,2,W
1973-05-12,0,BOS,10,2,15510,154,-8,NW
1973-05-13,0,BOS,3,8,13711,178,5,W
1973-05-14,0,BOS,0,1,13020,188,1,W
1973-05-22,0,BOS,4,2,10554,143,-2,NW
1973-05-23,0,BOS,3,5,10464,165,2,W
1973-05-24,0,BOS,1,10,8416,147,9,W
1973-05-29,0,BOS,1,2,12691,152,1,W
1973-05-30,0,BOS,1,2,11809,133,1,W
1973-05-31,0,BOS,7,6,10600,158,-1,NW
1973-06-01,0,BOS,2,6,28053,150,4,W
1973-06-02,0,BOS,3,1,27692,120,-2,NW
1973-06-03,0,BOS,12,1,31497,173,-11,NW
1973-06-04,0,BOS,3,9,10653,170,6,W
1973-06-05,0,BOS,2,9,10966,174,7,W
1973-06-06,0,BOS,4,5,12488,140,1,W
1973-06-21,0,BOS,6,3,21876,173,-3,NW
1973-06-23,1,BOS,1,5,0,157,4,W
1973-06-23,2,BOS,2,1,30676,165,-1,NW
1973-06-24,0,BOS,0,1,26244,120,1,W
1973-06-25,0,BOS,1,2,20837,123,1,W
1973-06-26,0,BOS,4,1,20152,182,-3,NW
1973-06-28,1,BOS,4,2,0,162,-2,NW
1973-06-28,2,BOS,7,16,15139,183,9,W
1973-07-01,1,BOS,9,5,0,170,-4,NW
1973-07-01,2,BOS,2,4,25754,131,2,W
1973-07-12,0,BOS,2,5,31896,117,3,W
1973-07-13,0,BOS,4,1,19375,138,-3,NW
1973-07-14,0,BOS,5,6,13253,144,1,W
1973-07-15,0,BOS,1,3,11793,97,2,W
1973-07-16,0,BOS,8,9,20772,201,1,W
1973-07-17,1,BOS,8,4,25517,166,-4,NW
1973-07-17,2,BOS,5,0,23191,144,-5,NW
1973-07-18,0,BOS,1,6,15809,135,5,W
1973-07-19,0,BOS,6,2,21359,147,-4,NW
1973-07-20,0,BOS,0,5,22996,153,5,W
1973-07-21,0,BOS,2,3,19492,172,1,W
1973-07-22,0,BOS,10,7,28656,177,-3,NW
1973-07-30,0,BOS,3,4,31700,157,1,W
1973-07-31,0,BOS,5,4,33084,154,-1,NW
1973-08-01,0,BOS,2,3,30689,169,1,W
1973-08-02,0,BOS,0,10,30393,163,10,W
1973-08-10,0,BOS,5,3,24856,162,-2,NW
1973-08-11,0,BOS,1,2,19046,157,1,W
1973-08-12,0,BOS,8,14,20522,198,6,W
1973-08-13,0,BOS,3,1,29960,165,-2,NW
1973-08-14,0,BOS,1,0,29084,153,-1,NW
1973-08-16,0,BOS,6,3,20424,162,-3,NW
1973-08-17,0,BOS,4,6,27224,177,2,W
1973-08-18,0,BOS,5,8,20065,153,3,W
1973-08-19,0,BOS,3,4,27356,192,1,W
1973-09-03,1,BOS,13,8,27730,207,-5,NW
1973-09-03,2,BOS,8,9,22267,179,1,W
1973-09-04,0,BOS,1,2,18808,193,1,W
1973-09-05,0,BOS,5,7,21758,155,2,W
1973-09-07,0,BOS,3,11,29147,167,8,W
1973-09-08,0,BOS,6,1,24694,175,-5,NW
1973-09-09,0,BOS,5,4,25224,163,-1,NW
1973-09-14,0,BOS,4,6,11606,133,2,W
1973-09-15,0,BOS,9,8,11478,162,-1,NW
1973-09-16,0,BOS,5,1,12743,150,-4,NW
1973-09-18,0,BOS,2,4,17409,140,2,W
1973-09-19,0,BOS,1,3,17453,130,2,W
1973-09-28,1,BOS,2,11,0,129,9,W
1973-09-28,2,BOS,3,5,13195,138,2,W
1973-09-29,0,BOS,4,9,6882,137,5,W
1973-09-30,0,BOS,2,3,11675,129,1,W
1974-04-11,0,BOS,7,6,23441,223,-1,NW
1974-04-12,0,BOS,3,6,8481,143,3,W
1974-04-13,0,BOS,1,8,8159,149,7,W
1974-04-14,0,BOS,5,7,11274,151,2,W
1974-04-15,0,BOS,1,0,23498,110,-1,NW
1974-04-19,0,BOS,3,6,9098,121,3,W
1974-04-20,0,BOS,4,5,11667,137,1,W
1974-04-21,0,BOS,5,6,14954,173,1,W
1974-04-22,0,BOS,1,4,11927,137,3,W
1974-04-23,0,BOS,5,2,5388,169,-3,NW
1974-04-29,0,BOS,7,2,9674,136,-5,NW
1974-04-30,0,BOS,16,6,7395,177,-10,NW
1974-05-01,0,BOS,4,2,6534,166,-2,NW
1974-05-04,0,BOS,1,0,9984,122,-1,NW
1974-05-05,1,BOS,5,3,0,154,-2,NW
1974-05-05,2,BOS,8,10,17190,183,2,W
1974-05-08,0,BOS,0,4,13985,122,4,W
1974-05-09,0,BOS,0,2,12193,123,2,W
1974-05-21,0,BOS,6,14,15208,175,8,W
1974-05-22,0,BOS,3,6,16466,147,3,W
1974-05-24,0,BOS,3,5,15951,161,2,W
1974-05-25,0,BOS,9,2,19827,163,-7,NW
1974-05-26,0,BOS,1,4,14412,142,3,W
1974-05-27,0,BOS,2,3,11977,167,1,W
1974-05-28,0,BOS,5,9,10811,154,4,W
1974-05-29,0,BOS,5,4,9429,232,-1,NW
1974-05-31,0,BOS,3,2,21398,133,-1,NW
1974-06-01,0,BOS,0,8,20404,125,8,W
1974-06-02,0,BOS,7,9,22219,152,2,W
1974-06-10,0,BOS,1,4,28537,146,3,W
1974-06-11,0,BOS,9,10,24762,161,1,W
1974-06-12,0,BOS,3,5,27079,159,2,W
1974-06-22,1,BOS,11,0,26936,172,-11,NW
1974-06-22,2,BOS,3,8,18623,163,5,W
1974-06-23,0,BOS,0,8,21496,160,8,W
1974-06-24,0,BOS,0,9,26562,149,9,W
1974-06-26,0,BOS,7,1,17826,113,-6,NW
1974-07-03,1,BOS,9,2,0,165,-7,NW
1974-07-03,2,BOS,6,4,27730,157,-2,NW
1974-07-04,0,BOS,10,6,13622,180,-4,NW
1974-07-06,0,BOS,5,3,23331,178,-2,NW
1974-07-07,1,BOS,11,9,0,237,-2,NW
1974-07-07,2,BOS,3,5,21146,174,2,W
1974-07-08,0,BOS,5,0,19012,144,-5,NW
1974-07-09,0,BOS,1,2,15051,134,1,W
1974-07-10,0,BOS,1,3,17190,143,2,W
1974-07-11,0,BOS,3,12,25915,149,9,W
1974-07-12,0,BOS,7,0,24821,176,-7,NW
1974-07-13,0,BOS,12,1,23862,155,-11,NW
1974-07-14,0,BOS,0,3,17199,166,3,W
1974-07-27,0,BOS,4,5,34834,165,1,W
1974-07-28,0,BOS,3,8,33718,141,5,W
1974-07-29,0,BOS,1,2,30889,209,1,W
1974-07-30,0,BOS,7,5,21456,156,-2,NW
1974-07-31,0,BOS,4,5,24935,139,1,W
1974-08-01,0,BOS,3,11,27596,146,8,W
1974-08-02,0,BOS,5,7,25046,159,2,W
1974-08-16,0,BOS,2,3,33218,177,1,W
1974-08-17,0,BOS,7,4,27979,149,-3,NW
1974-08-18,0,BOS,6,9,24384,163,3,W
1974-08-19,0,BOS,1,6,23923,116,5,W
1974-08-20,0,BOS,3,8,27881,160,5,W
1974-08-21,0,BOS,0,4,32395,124,4,W
1974-08-23,0,BOS,0,3,35866,133,3,W
1974-08-24,0,BOS,4,1,34693,162,-3,NW
1974-08-25,0,BOS,7,0,34293,127,-7,NW
1974-09-05,0,BOS,4,3,14592,164,-1,NW
1974-09-06,0,BOS,2,0,19257,144,-2,NW
1974-09-07,0,BOS,3,4,16553,179,1,W
1974-09-08,0,BOS,6,8,25531,170,2,W
1974-09-09,0,BOS,6,3,34981,152,-3,NW
1974-09-10,0,BOS,2,1,33174,195,-1,NW
1974-09-17,0,BOS,5,3,12213,132,-2,NW
1974-09-18,0,BOS,5,8,12213,152,3,W
1974-09-19,0,BOS,3,1,12290,121,-2,NW
1974-09-20,0,BOS,2,1,27283,125,-1,NW
1974-09-21,0,BOS,5,6,21555,186,1,W
1974-09-22,0,BOS,7,2,26495,185,-5,NW
1974-09-30,0,BOS,2,1,10673,149,-1,NW
1974-10-01,0,BOS,4,7,9784,136,3,W
1974-10-02,0,BOS,8,6,5047,160,-2,NW
1975-04-08,0,BOS,2,5,34055,144,3,W
1975-04-09,0,BOS,7,4,7643,151,-3,NW
1975-04-18,0,BOS,9,7,8219,137,-2,NW
1975-04-20,0,BOS,2,10,17765,128,8,W
1975-04-21,0,BOS,12,1,28381,165,-11,NW
1975-04-22,0,BOS,5,0,16922,131,-5,NW
1975-04-23,0,BOS,7,11,22243,184,4,W
1975-04-30,0,BOS,8,1,9307,150,-7,NW
1975-05-01,0,BOS,6,7,6016,141,1,W
1975-05-03,0,BOS,2,12,13153,155,10,W
1975-05-15,0,BOS,3,0,10300,146,-3,NW
1975-05-16,0,BOS,5,2,12213,160,-3,NW
1975-05-17,0,BOS,5,3,10907,166,-2,NW
1975-05-18,0,BOS,2,4,16657,154,2,W
1975-05-19,0,BOS,5,10,14700,150,5,W
1975-05-20,0,BOS,0,7,17201,111,7,W
1975-05-21,0,BOS,3,7,14665,116,4,W
1975-05-22,0,BOS,6,3,9155,122,-3,NW
1975-05-23,0,BOS,1,6,20587,124,5,W
1975-05-24,0,BOS,0,6,11805,108,6,W
1975-05-25,0,BOS,6,1,16401,153,-5,NW
1975-06-02,0,BOS,9,2,15681,147,-7,NW
1975-06-03,0,BOS,0,4,10625,122,4,W
1975-06-04,0,BOS,6,7,12366,148,1,W
1975-06-06,0,BOS,10,13,18120,173,3,W
1975-06-07,0,BOS,1,3,18649,129,2,W
1975-06-08,0,BOS,7,5,18301,168,-2,NW
1975-06-09,0,BOS,12,4,13597,172,-8,NW
1975-06-10,0,BOS,8,3,20919,156,-5,NW
1975-06-23,0,BOS,11,3,19591,167,-8,NW
1975-06-24,0,BOS,8,6,15411,173,-2,NW
1975-06-25,0,BOS,8,5,20847,166,-3,NW
1975-06-26,0,BOS,1,6,34293,144,5,W
1975-06-27,0,BOS,1,9,35489,136,8,W
1975-06-28,0,BOS,8,6,32631,168,-2,NW
1975-06-29,0,BOS,2,3,33752,121,1,W
1975-06-30,1,BOS,2,5,0,147,3,W
1975-06-30,2,BOS,8,2,32817,154,-6,NW
1975-07-01,0,BOS,10,6,22239,205,-4,NW
1975-07-07,0,BOS,3,6,21885,177,3,W
1975-07-08,0,BOS,5,6,17519,187,1,W
1975-07-09,0,BOS,8,9,21103,172,1,W
1975-07-10,0,BOS,7,8,17365,172,1,W
1975-07-11,0,BOS,8,11,27178,179,3,W
1975-07-12,0,BOS,4,10,20694,174,6,W
1975-07-13,0,BOS,5,7,26170,186,2,W
1975-07-17,0,BOS,3,8,28794,155,5,W
1975-07-18,0,BOS,3,9,30226,127,6,W
1975-07-28,0,BOS,6,7,33606,199,1,W
1975-07-29,0,BOS,4,0,33506,156,-4,NW
1975-07-30,0,BOS,6,2,33763,132,-4,NW
1975-07-31,1,BOS,2,3,0,151,1,W
1975-07-31,2,BOS,1,6,31317,138,5,W
1975-08-01,0,BOS,7,8,26537,149,1,W
1975-08-02,0,BOS,2,7,27188,158,5,W
1975-08-03,0,BOS,4,6,23575,116,2,W
1975-08-04,0,BOS,12,8,35866,189,-4,NW
1975-08-05,0,BOS,3,0,35662,119,-3,NW
1975-08-22,0,BOS,1,2,32458,132,1,W
1975-08-23,0,BOS,6,4,27730,171,-2,NW
1975-08-24,0,BOS,1,6,22024,126,5,W
1975-08-26,0,BOS,8,2,32086,162,-6,NW
1975-08-27,0,BOS,2,6,34227,153,4,W
1975-08-29,0,BOS,1,6,34341,159,5,W
1975-08-30,0,BOS,7,6,28171,202,-1,NW
1975-08-31,0,BOS,8,6,32753,229,-2,NW
1975-09-01,0,BOS,4,2,30218,172,-2,NW
1975-09-02,0,BOS,4,7,28598,154,3,W
1975-09-10,1,BOS,4,7,0,158,3,W
1975-09-10,2,BOS,5,3,20189,147,-2,NW
1975-09-11,0,BOS,1,3,9508,116,2,W
1975-09-13,1,BOS,9,6,28515,193,-3,NW
1975-09-13,2,BOS,3,6,20974,149,3,W
1975-09-14,0,BOS,6,8,28187,156,2,W
1975-09-15,0,BOS,7,9,16302,180,2,W
1975-09-16,0,BOS,0,2,34724,133,2,W
1975-09-17,0,BOS,5,2,31806,153,-3,NW
1975-09-26,1,BOS,0,4,0,146,4,W
1975-09-26,2,BOS,0,4,22067,116,4,W
1975-09-27,0,BOS,5,2,22072,143,-3,NW
1975-09-28,0,BOS,11,4,25991,153,-7,NW
1976-04-13,0,BOS,4,7,32127,170,3,W
1976-04-14,0,BOS,6,5,14315,153,-1,NW
1976-04-15,0,BOS,8,4,10916,146,-4,NW
1976-04-17,0,BOS,1,7,24328,155,6,W
1976-04-18,0,BOS,10,4,18971,138,-6,NW
1976-04-19,0,BOS,0,2,34158,125,2,W
1976-04-20,0,BOS,3,12,22147,143,9,W
1976-05-04,0,BOS,7,5,16274,167,-2,NW
1976-05-05,0,BOS,8,4,17596,172,-4,NW
1976-05-08,1,BOS,6,5,0,172,-1,NW
1976-05-08,2,BOS,12,4,23737,159,-8,NW
1976-05-09,0,BOS,6,5,18618,170,-1,NW
1976-05-14,0,BOS,1,2,25069,147,1,W
1976-05-15,0,BOS,4,9,26327,146,5,W
1976-05-16,0,BOS,11,5,28814,165,-6,NW
1976-05-24,0,BOS,0,3,20590,124,3,W
1976-05-25,0,BOS,0,2,21033,117,2,W
1976-05-28,0,BOS,4,1,33250,130,-3,NW
1976-05-29,0,BOS,7,2,33238,146,-5,NW
1976-05-30,0,BOS,1,3,28300,135,2,W
1976-05-31,0,BOS,8,3,35939,157,-5,NW
1976-06-02,0,BOS,7,2,30110,136,-5,NW
1976-06-03,0,BOS,2,8,29505,152,6,W
1976-06-04,0,BOS,5,4,23154,188,-1,NW
1976-06-05,0,BOS,3,4,25784,143,1,W
1976-06-06,0,BOS,1,4,26003,169,3,W
1976-06-08,0,BOS,6,5,26704,177,-1,NW
1976-06-09,0,BOS,4,6,24191,173,2,W
1976-06-10,0,BOS,8,5,27364,166,-3,NW
1976-06-24,0,BOS,6,3,26293,151,-3,NW
1976-06-25,0,BOS,6,2,27942,148,-4,NW
1976-06-26,0,BOS,1,2,28520,117,1,W
1976-06-27,0,BOS,4,2,29809,192,-2,NW
1976-06-28,0,BOS,8,12,27648,173,4,W
1976-06-29,0,BOS,0,2,30054,133,2,W
1976-06-30,0,BOS,4,6,29348,147,2,W
1976-07-05,0,BOS,2,11,24640,158,9,W
1976-07-06,0,BOS,0,4,31423,120,4,W
1976-07-07,0,BOS,6,3,27281,162,-3,NW
1976-07-08,0,BOS,4,8,25970,160,4,W
1976-07-09,0,BOS,8,6,29917,174,-2,NW
1976-07-10,0,BOS,4,2,28347,181,-2,NW
1976-07-11,0,BOS,4,6,26580,156,2,W
1976-07-26,0,BOS,9,4,21897,152,-5,NW
1976-07-27,0,BOS,7,8,20969,169,1,W
1976-07-28,0,BOS,7,6,22246,192,-1,NW
1976-07-29,0,BOS,4,6,29412,183,2,W
1976-07-30,0,BOS,6,4,27728,155,-2,NW
1976-07-31,1,BOS,2,4,28799,143,2,W
1976-07-31,2,BOS,4,6,26637,148,2,W
1976-08-01,0,BOS,4,5,29127,164,1,W
1976-08-06,0,BOS,1,2,25544,127,1,W
1976-08-07,0,BOS,0,3,24514,141,3,W
1976-08-20,0,BOS,1,2,30132,144,1,W
1976-08-21,0,BOS,2,5,27299,137,3,W
1976-08-22,0,BOS,7,6,27526,212,-1,NW
1976-08-23,0,BOS,3,7,24125,159,4,W
1976-08-24,0,BOS,6,5,24104,160,-1,NW
1976-08-25,0,BOS,2,8,21513,165,6,W
1976-08-26,0,BOS,7,6,24199,286,-1,NW
1976-08-27,0,BOS,4,9,24940,153,5,W
1976-08-28,0,BOS,8,3,27058,196,-5,NW
1976-08-29,0,BOS,6,15,26747,170,9,W
1976-08-30,0,BOS,3,11,17101,173,8,W
1976-08-31,0,BOS,8,3,18145,183,-5,NW
1976-09-01,0,BOS,0,3,19330,134,3,W
1976-09-08,0,BOS,3,4,13966,110,1,W
1976-09-09,0,BOS,0,5,13643,120,5,W
1976-09-10,0,BOS,1,0,19192,57,-1,NW
1976-09-11,0,BOS,6,5,21421,152,-1,NW
1976-09-12,0,BOS,3,11,24819,128,8,W
1976-09-13,0,BOS,8,3,12101,155,-5,NW
1976-09-21,1,BOS,1,7,0,138,6,W
1976-09-21,2,BOS,3,1,17840,122,-2,NW
1976-09-22,0,BOS,3,6,11796,173,3,W
1976-09-23,0,BOS,3,10,6154,138,7,W
1976-09-28,0,BOS,5,7,21200,142,2,W
1976-09-29,0,BOS,9,6,23980,145,-3,NW
1976-10-01,0,BOS,4,7,15749,163,3,W
1976-10-02,0,BOS,0,1,12753,111,1,W
1976-10-03,0,BOS,2,3,19845,241,1,W
1977-04-07,0,BOS,5,4,34790,200,-1,NW
1977-04-10,0,BOS,19,9,14931,237,-10,NW
1977-04-18,0,BOS,3,5,30059,146,2,W
1977-04-19,0,BOS,3,11,16941,148,8,W
1977-04-20,0,BOS,3,2,20289,137,-1,NW
1977-04-21,0,BOS,8,0,24903,130,-8,NW
1977-04-29,0,BOS,4,7,17411,129,3,W
1977-04-30,0,BOS,4,8,22999,165,4,W
1977-05-01,0,BOS,4,6,22053,154,2,W
1977-05-03,0,BOS,10,8,12422,187,-2,NW
1977-05-04,0,BOS,2,5,11408,145,3,W
1977-05-05,0,BOS,2,5,10358,135,3,W
1977-05-06,0,BOS,8,4,24301,183,-4,NW
1977-05-07,0,BOS,0,3,28426,136,3,W
1977-05-08,0,BOS,3,4,20864,137,1,W
1977-05-20,0,BOS,15,7,25991,168,-8,NW
1977-05-21,0,BOS,9,10,25405,187,1,W
1977-05-22,1,BOS,10,14,0,194,4,W
1977-05-22,2,BOS,6,0,29653,165,-6,NW
1977-05-25,1,BOS,13,5,0,195,-8,NW
1977-05-25,2,BOS,9,4,24686,173,-5,NW
1977-05-27,0,BOS,1,10,23472,143,9,W
1977-05-28,0,BOS,12,17,26126,201,5,W
1977-05-29,0,BOS,3,0,26920,160,-3,NW
1977-05-30,0,BOS,5,4,35521,144,-1,NW
1977-05-31,0,BOS,1,5,30102,124,4,W
1977-06-08,0,BOS,5,14,22943,198,9,W
1977-06-09,0,BOS,3,7,24064,166,4,W
1977-06-12,1,BOS,2,3,0,149,1,W
1977-06-12,2,BOS,0,2,31038,147,2,W
1977-06-13,0,BOS,4,5,23114,165,1,W
1977-06-14,0,BOS,1,7,27147,125,6,W
1977-06-16,0,BOS,7,3,32031,155,-4,NW
1977-06-17,0,BOS,4,9,34557,147,5,W
1977-06-18,0,BOS,4,10,34603,158,6,W
1977-06-19,0,BOS,1,11,34750,143,10,W
1977-07-01,0,BOS,8,2,33481,172,-6,NW
1977-07-02,0,BOS,5,2,32987,138,-3,NW
1977-07-03,0,BOS,12,8,31081,194,-4,NW
1977-07-04,0,BOS,6,9,21073,166,3,W
1977-07-06,0,BOS,5,9,34956,178,4,W
1977-07-07,0,BOS,2,5,32641,146,3,W
1977-07-21,1,BOS,4,11,20173,173,7,W
1977-07-21,2,BOS,8,2,29059,152,-6,NW
1977-07-22,0,BOS,0,3,34030,161,3,W
1977-07-23,0,BOS,9,8,35592,196,-1,NW
1977-07-24,0,BOS,9,6,34490,166,-3,NW
1977-07-25,0,BOS,8,7,27505,174,-1,NW
1977-07-26,0,BOS,3,4,30950,135,1,W
1977-07-27,0,BOS,14,5,31417,207,-9,NW
1977-07-28,0,BOS,0,12,34705,145,12,W
1977-08-10,0,BOS,10,11,34869,187,1,W
1977-08-11,0,BOS,7,3,35691,148,-4,NW
1977-08-12,0,BOS,2,7,27005,175,5,W
1977-08-13,0,BOS,6,13,34095,161,7,W
1977-08-14,0,BOS,1,11,31223,156,10,W
1977-08-15,0,BOS,1,2,33424,165,1,W
1977-08-16,0,BOS,3,5,35748,148,2,W
1977-08-24,1,BOS,3,0,0,146,-3,NW
1977-08-24,2,BOS,6,3,31784,181,-3,NW
1977-08-25,0,BOS,6,9,30186,184,3,W
1977-08-26,0,BOS,6,4,33415,145,-2,NW
1977-08-27,0,BOS,5,7,34636,143,2,W
1977-08-28,0,BOS,5,6,31619,155,1,W
1977-08-29,0,BOS,8,7,29750,204,-1,NW
1977-08-30,0,BOS,2,7,27264,151,5,W
1977-08-31,0,BOS,4,3,29226,195,-1,NW
1977-09-01,0,BOS,1,3,31736,158,2,W
1977-09-09,1,BOS,1,5,0,155,4,W
1977-09-09,2,BOS,6,8,34581,183,2,W
1977-09-10,0,BOS,1,7,26782,159,6,W
1977-09-11,0,BOS,2,6,34325,143,4,W
1977-09-19,0,BOS,3,6,34346,136,3,W
1977-09-21,0,BOS,2,3,30212,153,1,W
1977-09-27,1,BOS,5,6,0,137,1,W
1977-09-27,2,BOS,1,5,23952,153,4,W
1977-09-28,0,BOS,3,2,20362,138,-1,NW
1977-09-29,0,BOS,3,7,12240,150,4,W
1977-09-30,0,BOS,10,11,28553,206,1,W
1977-10-01,0,BOS,8,7,29107,171,-1,NW
1978-04-14,0,BOS,4,5,34747,191,1,W
1978-04-15,0,BOS,4,12,18624,150,8,W
1978-04-16,0,BOS,6,8,22168,168,2,W
1978-04-17,0,BOS,2,9,26075,165,7,W
1978-04-18,0,BOS,6,7,18928,169,1,W
1978-04-20,0,BOS,4,10,16238,155,6,W
1978-04-21,0,BOS,7,9,25401,155,2,W
1978-04-22,0,BOS,13,4,36005,172,-9,NW
1978-04-23,1,BOS,3,6,0,173,3,W
1978-04-23,2,BOS,10,7,36246,226,-3,NW
1978-05-01,0,BOS,6,9,18710,201,3,W
1978-05-02,0,BOS,3,1,19930,163,-2,NW
1978-05-03,0,BOS,9,11,16403,216,2,W
1978-05-04,0,BOS,1,8,15784,139,7,W
1978-05-06,1,BOS,4,6,0,196,2,W
1978-05-06,2,BOS,0,3,32238,131,3,W
1978-05-07,0,BOS,0,5,30921,120,5,W
1978-05-08,0,BOS,4,8,25891,146,4,W
1978-05-09,0,BOS,3,4,22369,129,1,W
1978-05-26,0,BOS,3,6,33431,141,3,W
1978-05-27,0,BOS,0,1,33335,151,1,W
1978-05-28,1,BOS,3,4,0,165,1,W
1978-05-28,2,BOS,3,4,34672,139,1,W
1978-05-29,0,BOS,4,5,25935,134,1,W
1978-05-30,0,BOS,0,4,25853,137,4,W
1978-05-31,0,BOS,6,2,27945,153,-4,NW
1978-06-12,0,BOS,9,10,31652,195,1,W
1978-06-13,0,BOS,0,5,26539,132,5,W
1978-06-14,0,BOS,0,9,29690,130,9,W
1978-06-15,0,BOS,3,7,32281,175,4,W
1978-06-16,0,BOS,3,6,31519,161,3,W
1978-06-17,0,BOS,4,5,32551,133,1,W
1978-06-18,0,BOS,3,2,28961,166,-1,NW
1978-06-19,0,BOS,4,10,33163,168,6,W
1978-06-20,0,BOS,10,4,32643,193,-6,NW
1978-06-21,0,BOS,2,9,32459,158,7,W
1978-06-23,0,BOS,2,5,34582,139,3,W
1978-06-24,0,BOS,3,8,32213,162,5,W
1978-06-25,0,BOS,1,4,33526,168,3,W
1978-07-03,0,BOS,5,9,34722,174,4,W
1978-07-13,0,BOS,12,7,33995,169,-5,NW
1978-07-14,0,BOS,4,3,32899,165,-1,NW
1978-07-15,0,BOS,4,5,32861,169,1,W
1978-07-16,1,BOS,3,5,0,179,2,W
1978-07-16,2,BOS,2,3,35589,142,1,W
1978-07-17,0,BOS,2,3,33233,197,1,W
1978-07-28,0,BOS,4,0,35348,149,-4,NW
1978-07-29,0,BOS,0,1,35098,141,1,W
1978-07-30,0,BOS,2,1,34626,151,-1,NW
1978-07-31,0,BOS,2,9,28858,176,7,W
1978-08-01,0,BOS,5,2,30020,142,-3,NW
1978-08-08,0,BOS,7,9,34485,166,2,W
1978-08-09,0,BOS,5,1,33285,158,-4,NW
1978-08-10,0,BOS,5,6,33541,278,1,W
1978-08-11,0,BOS,10,5,35142,209,-5,NW
1978-08-12,1,BOS,1,3,33092,134,2,W
1978-08-12,2,BOS,4,11,27030,145,7,W
1978-08-13,0,BOS,3,4,34460,198,1,W
1978-08-14,0,BOS,4,3,33766,161,-1,NW
1978-08-25,0,BOS,0,6,33583,148,6,W
1978-08-26,0,BOS,1,7,33531,138,6,W
1978-08-27,0,BOS,3,4,34216,254,1,W
1978-08-28,0,BOS,9,10,24301,181,1,W
1978-08-29,0,BOS,5,10,32393,156,5,W
1978-08-30,1,BOS,1,2,0,135,1,W
1978-08-30,2,BOS,7,6,32825,187,-1,NW
1978-09-01,0,BOS,5,1,30156,179,-4,NW
1978-09-02,0,BOS,4,3,33051,156,-1,NW
1978-09-03,0,BOS,6,11,29029,181,5,W
1978-09-07,0,BOS,15,3,34119,189,-12,NW
1978-09-08,0,BOS,13,2,33134,175,-11,NW
1978-09-09,0,BOS,7,0,33611,146,-7,NW
1978-09-10,0,BOS,7,4,32786,177,-3,NW
1978-09-11,0,BOS,4,5,28575,164,1,W
1978-09-12,0,BOS,3,2,28924,156,-1,NW
1978-09-26,0,BOS,0,6,27078,158,6,W
1978-09-27,0,BOS,2,5,26035,138,3,W
1978-09-28,0,BOS,0,1,26774,141,1,W
1978-09-29,0,BOS,0,11,29626,143,11,W
1978-09-30,0,BOS,1,5,32659,129,4,W
1978-10-01,0,BOS,0,5,29201,131,5,W
1978-10-02,0,BOS,5,4,32925,172,-1,NW
1979-04-05,0,BOS,1,7,34433,162,6,W
1979-04-15,0,BOS,4,14,16460,182,10,W
1979-04-16,0,BOS,4,3,27439,151,-1,NW
1979-04-17,0,BOS,5,6,16053,201,1,W
1979-04-18,0,BOS,4,1,19213,124,-3,NW
1979-04-19,0,BOS,3,5,20485,136,2,W
1979-04-20,0,BOS,2,9,20925,153,7,W
1979-04-21,0,BOS,4,10,34332,174,6,W
1979-04-22,0,BOS,0,6,32089,136,6,W
1979-05-04,0,BOS,3,5,21903,122,2,W
1979-05-05,0,BOS,4,11,25714,178,7,W
1979-05-06,0,BOS,3,2,25919,139,-1,NW
1979-05-07,0,BOS,4,9,23319,164,5,W
1979-05-08,0,BOS,10,2,21160,149,-8,NW
1979-05-09,0,BOS,8,9,24815,199,1,W
1979-05-10,0,BOS,5,3,24990,169,-2,NW
1979-05-11,0,BOS,2,11,26637,147,9,W
1979-05-12,0,BOS,2,8,30617,152,6,W
1979-05-13,0,BOS,2,8,25651,147,6,W
1979-05-15,0,BOS,2,3,25222,164,1,W
1979-05-16,0,BOS,10,6,27569,176,-4,NW
1979-05-17,0,BOS,2,6,27610,171,4,W
1979-05-18,0,BOS,10,0,33694,159,-10,NW
1979-05-19,0,BOS,3,4,33224,151,1,W
1979-05-20,0,BOS,2,0,33932,118,-2,NW
1979-06-04,0,BOS,5,13,27698,173,8,W
1979-06-05,0,BOS,3,9,27670,142,6,W
1979-06-06,0,BOS,8,5,26356,176,-3,NW
1979-06-07,0,BOS,2,9,25842,152,7,W
1979-06-08,0,BOS,1,2,33953,140,1,W
1979-06-09,0,BOS,6,12,34324,163,6,W
1979-06-10,0,BOS,0,5,34304,118,5,W
1979-06-18,0,BOS,8,9,29533,210,1,W
1979-06-19,0,BOS,10,4,34153,275,-6,NW
1979-06-20,0,BOS,3,13,34035,158,10,W
1979-06-21,0,BOS,2,3,34316,140,1,W
1979-06-22,0,BOS,1,12,31089,151,11,W
1979-06-23,0,BOS,3,4,34130,195,1,W
1979-06-24,0,BOS,4,8,33560,139,4,W
1979-07-03,0,BOS,0,10,34814,162,10,W
1979-07-04,0,BOS,4,6,27870,162,2,W
1979-07-05,0,BOS,4,5,34795,161,1,W
1979-07-19,0,BOS,1,7,32207,156,6,W
1979-07-20,0,BOS,8,0,33397,151,-8,NW
1979-07-21,0,BOS,13,5,33048,183,-8,NW
1979-07-22,0,BOS,5,6,35172,167,1,W
1979-07-23,0,BOS,9,2,35024,180,-7,NW
1979-07-24,0,BOS,3,7,30393,153,4,W
1979-07-25,0,BOS,4,16,31142,154,12,W
1979-07-26,0,BOS,8,6,32660,196,-2,NW
1979-08-07,0,BOS,3,12,31204,165,9,W
1979-08-08,1,BOS,6,4,31756,184,-2,NW
1979-08-08,2,BOS,8,2,30141,138,-6,NW
1979-08-09,0,BOS,2,3,31835,131,1,W
1979-08-10,0,BOS,4,5,32914,155,1,W
1979-08-11,0,BOS,9,6,33343,194,-3,NW
1979-08-13,0,BOS,5,6,32359,147,1,W
1979-08-14,0,BOS,1,12,32962,151,11,W
1979-08-15,0,BOS,5,9,33539,183,4,W
1979-08-16,0,BOS,5,7,33806,161,2,W
1979-08-17,0,BOS,4,1,35114,142,-3,NW
1979-08-18,0,BOS,2,8,33969,98,6,W
1979-08-19,0,BOS,3,2,33475,149,-1,NW
1979-08-30,0,BOS,6,0,32399,134,-6,NW
1979-08-31,0,BOS,6,9,31314,156,3,W
1979-09-01,0,BOS,5,4,28930,173,-1,NW
1979-09-02,0,BOS,7,6,30133,179,-1,NW
1979-09-07,0,BOS,2,1,33222,153,-1,NW
1979-09-08,0,BOS,3,2,33819,153,-1,NW
1979-09-09,0,BOS,16,4,34419,175,-12,NW
1979-09-10,0,BOS,2,3,30618,138,1,W
1979-09-11,0,BOS,8,3,35689,168,-5,NW
1979-09-12,0,BOS,2,9,34336,128,7,W
1979-09-13,0,BOS,10,3,32474,156,-7,NW
1979-09-21,0,BOS,1,4,24802,105,3,W
1979-09-23,1,BOS,1,2,0,137,1,W
1979-09-23,2,BOS,3,2,31871,156,-1,NW
1979-09-25,0,BOS,5,3,18929,136,-2,NW
1979-09-26,0,BOS,4,6,18010,130,2,W
1979-09-27,0,BOS,5,6,20853,149,1,W
1980-04-14,0,BOS,1,3,33512,134,2,W
1980-04-16,0,BOS,9,10,9238,183,1,W
1980-04-17,0,BOS,4,5,8626,202,1,W
1980-04-18,0,BOS,6,5,10580,168,-1,NW
1980-04-19,0,BOS,8,0,22715,183,-8,NW
1980-04-20,0,BOS,5,6,23696,203,1,W
1980-04-21,0,BOS,8,9,27990,157,1,W
1980-04-22,0,BOS,2,0,13230,139,-2,NW
1980-04-24,0,BOS,9,3,12385,173,-6,NW
1980-05-09,0,BOS,6,5,28597,166,-1,NW
1980-05-10,0,BOS,13,8,30519,183,-5,NW
1980-05-11,0,BOS,2,5,24685,144,3,W
1980-05-12,0,BOS,4,3,18486,162,-1,NW
1980-05-13,0,BOS,5,10,19032,177,5,W
1980-05-14,0,BOS,6,7,24590,161,1,W
1980-05-23,0,BOS,1,4,21857,136,3,W
1980-05-24,0,BOS,7,2,22719,165,-5,NW
1980-05-25,0,BOS,3,2,24391,143,-1,NW
1980-05-26,0,BOS,3,1,18853,162,-2,NW
1980-05-27,0,BOS,4,5,16679,148,1,W
1980-05-28,0,BOS,4,1,18215,145,-3,NW
1980-05-30,0,BOS,3,5,28238,144,2,W
1980-05-31,0,BOS,19,8,30381,192,-11,NW
1980-06-01,0,BOS,8,5,31157,171,-3,NW
1980-06-16,0,BOS,11,8,25026,173,-3,NW
1980-06-17,0,BOS,2,6,24722,159,4,W
1980-06-18,0,BOS,2,6,22230,142,4,W
1980-06-19,0,BOS,0,2,23032,149,2,W
1980-06-20,0,BOS,20,2,28780,160,-18,NW
1980-06-21,0,BOS,4,2,33442,182,-2,NW
1980-06-22,0,BOS,3,6,30938,155,3,W
1980-06-27,0,BOS,2,3,31607,140,1,W
1980-06-28,0,BOS,8,4,30914,159,-4,NW
1980-06-30,0,BOS,6,3,33858,166,-3,NW
1980-07-01,0,BOS,3,2,35026,135,-1,NW
1980-07-02,0,BOS,6,0,33971,142,-6,NW
1980-07-12,0,BOS,3,9,31302,166,6,W
1980-07-13,0,BOS,4,8,31228,170,4,W
1980-07-14,0,BOS,12,4,26044,190,-8,NW
1980-07-15,0,BOS,8,4,26865,163,-4,NW
1980-07-16,0,BOS,5,1,27213,192,-4,NW
1980-07-17,0,BOS,4,12,25619,161,8,W
1980-07-18,0,BOS,0,1,28116,142,1,W
1980-07-19,0,BOS,4,0,32820,154,-4,NW
1980-07-20,0,BOS,5,4,28493,168,-1,NW
1980-07-21,0,BOS,5,3,24953,154,-2,NW
1980-07-22,0,BOS,4,3,24076,156,-1,NW
1980-07-23,0,BOS,5,12,25055,200,7,W
1980-08-04,0,BOS,2,7,27864,161,5,W
1980-08-05,0,BOS,1,3,27996,149,2,W
1980-08-06,0,BOS,9,4,28033,174,-5,NW
1980-08-07,0,BOS,3,7,27966,158,4,W
1980-08-08,0,BOS,1,4,29326,157,3,W
1980-08-09,0,BOS,5,4,32719,163,-1,NW
1980-08-10,0,BOS,3,4,30124,133,1,W
1980-08-28,0,BOS,2,3,28262,160,1,W
1980-08-29,0,BOS,3,6,28666,185,3,W
1980-08-30,0,BOS,6,7,27146,218,1,W
1980-08-31,0,BOS,1,5,32022,176,4,W
1980-09-01,0,BOS,3,4,23877,196,1,W
1980-09-02,0,BOS,2,10,19693,172,8,W
1980-09-03,0,BOS,7,2,22340,158,-5,NW
1980-09-04,0,BOS,7,4,18256,159,-3,NW
1980-09-05,0,BOS,4,2,20420,147,-2,NW
1980-09-06,0,BOS,1,5,23317,161,4,W
1980-09-07,0,BOS,12,6,23360,166,-6,NW
1980-09-11,0,BOS,8,5,32979,204,-3,NW
1980-09-12,0,BOS,4,2,33787,165,-2,NW
1980-09-13,0,BOS,4,3,33375,170,-1,NW
1980-09-14,0,BOS,5,3,33296,181,-2,NW
1980-09-16,0,BOS,5,9,14630,169,4,W
1980-09-17,0,BOS,6,5,15321,205,-1,NW
1980-09-18,0,BOS,3,8,14845,158,5,W
1980-09-29,1,BOS,5,2,0,145,-3,NW
1980-09-29,2,BOS,4,3,23002,150,-1,NW
1980-09-30,0,BOS,11,6,18393,165,-5,NW
1980-10-01,0,BOS,12,8,16781,193,-4,NW
1980-10-02,0,BOS,1,4,11872,113,3,W
1980-10-04,1,BOS,7,6,0,278,-1,NW
1980-10-04,2,BOS,3,1,14179,130,-2,NW
1980-10-05,0,BOS,4,1,16562,135,-3,NW
1981-04-10,0,BOS,5,3,35154,185,-2,NW
1981-04-12,0,BOS,4,5,21439,144,1,W
1981-04-13,0,BOS,5,1,8551,154,-4,NW
1981-04-15,0,BOS,2,7,8925,151,5,W
1981-04-20,0,BOS,2,4,26844,138,2,W
1981-04-21,0,BOS,4,10,13233,152,6,W
1981-04-22,0,BOS,16,8,15699,170,-8,NW
1981-04-30,0,BOS,8,4,15506,145,-4,NW
1981-05-01,0,BOS,6,1,15715,137,-5,NW
1981-05-02,0,BOS,11,2,16940,150,-9,NW
1981-05-03,0,BOS,3,1,15608,146,-2,NW
1981-05-15,0,BOS,3,4,22943,175,1,W
1981-05-16,0,BOS,7,6,26107,146,-1,NW
1981-05-17,0,BOS,5,4,26723,165,-1,NW
1981-05-18,0,BOS,5,8,12044,186,3,W
1981-05-19,0,BOS,0,4,12768,141,4,W
1981-05-20,0,BOS,3,5,23007,156,2,W
1981-05-21,0,BOS,0,3,23145,155,3,W
1981-05-25,0,BOS,7,8,20860,182,1,W
1981-05-26,0,BOS,5,2,16986,142,-3,NW
1981-05-27,0,BOS,5,10,17294,169,5,W
1981-05-29,0,BOS,5,4,22794,157,-1,NW
1981-05-30,0,BOS,6,7,23718,177,1,W
1981-05-31,0,BOS,5,2,23781,141,-3,NW
1981-08-10,0,BOS,7,1,20227,172,-6,NW
1981-08-11,0,BOS,4,2,17889,157,-2,NW
1981-08-12,0,BOS,1,8,20257,167,7,W
1981-08-13,0,BOS,6,9,18683,183,3,W
1981-08-27,0,BOS,5,6,23432,173,1,W
1981-08-28,0,BOS,5,12,25356,167,7,W
1981-08-29,0,BOS,6,7,26318,175,1,W
1981-08-30,0,BOS,5,3,25160,154,-2,NW
1981-08-31,0,BOS,1,4,20377,143,3,W
1981-09-01,0,BOS,3,2,19712,144,-1,NW
1981-09-02,0,BOS,1,3,19433,157,2,W
1981-09-03,0,BOS,8,7,13355,361,-1,NW
1981-09-04,0,BOS,5,2,20949,165,-3,NW
1981-09-05,0,BOS,5,12,15434,168,7,W
1981-09-06,0,BOS,1,6,17913,148,5,W
1981-09-14,0,BOS,2,5,13060,139,3,W
1981-09-16,1,BOS,1,2,0,158,1,W
1981-09-16,2,BOS,4,5,13312,157,1,W
1981-09-17,0,BOS,1,6,16832,186,5,W
1981-09-18,0,BOS,6,4,34283,140,-2,NW
1981-09-19,0,BOS,5,8,32620,164,3,W
1981-09-20,0,BOS,1,4,35091,139,3,W
1981-09-21,0,BOS,3,9,14575,150,6,W
1981-09-22,0,BOS,10,8,18363,157,-2,NW
1981-09-23,0,BOS,5,11,15627,199,6,W
1981-09-24,0,BOS,5,2,14720,174,-3,NW
1981-09-25,0,BOS,4,5,26136,141,1,W
1981-09-26,0,BOS,7,5,24034,157,-2,NW
1981-09-27,0,BOS,8,7,31727,202,-1,NW
1982-04-12,0,BOS,3,2,32555,182,-1,NW
1982-04-14,0,BOS,5,4,9780,153,-1,NW
1982-04-15,0,BOS,8,4,8743,160,-4,NW
1982-04-16,0,BOS,2,0,7542,124,-2,NW
1982-04-17,0,BOS,4,5,18617,137,1,W
1982-04-18,0,BOS,3,4,18017,137,1,W
1982-04-19,0,BOS,5,4,27265,146,-1,NW
1982-04-20,0,BOS,3,8,15253,160,5,W
1982-04-21,0,BOS,5,6,15725,166,1,W
1982-04-27,0,BOS,5,7,12998,151,2,W
1982-04-28,0,BOS,8,5,12368,151,-3,NW
1982-04-30,0,BOS,1,7,19370,148,6,W
1982-05-01,0,BOS,5,6,32764,215,1,W
1982-05-02,0,BOS,0,6,21011,135,6,W
1982-05-03,0,BOS,2,6,12065,139,4,W
1982-05-04,0,BOS,3,5,13726,135,2,W
1982-05-05,0,BOS,3,2,14685,145,-1,NW
1982-05-18,0,BOS,3,0,16436,122,-3,NW
1982-05-19,0,BOS,5,6,12927,213,1,W
1982-05-20,0,BOS,2,11,14587,163,9,W
1982-05-21,0,BOS,7,8,29671,159,1,W
1982-05-22,0,BOS,4,7,36654,173,3,W
1982-05-23,0,BOS,0,6,24421,119,6,W
1982-05-25,0,BOS,10,2,28238,146,-8,NW
1982-06-08,0,BOS,3,4,31413,155,1,W
1982-06-09,0,BOS,2,3,32792,146,1,W
1982-06-10,0,BOS,5,3,33462,177,-2,NW
1982-06-11,0,BOS,2,6,30846,131,4,W
1982-06-12,0,BOS,4,6,30531,172,2,W
1982-06-21,0,BOS,1,5,24234,155,4,W
1982-06-22,0,BOS,4,5,28215,188,1,W
1982-06-23,0,BOS,4,10,30547,166,6,W
1982-06-25,0,BOS,9,3,32656,172,-6,NW
1982-06-26,0,BOS,11,10,33393,166,-1,NW
1982-06-27,0,BOS,7,5,32744,149,-2,NW
1982-06-28,0,BOS,7,9,25773,151,2,W
1982-07-09,0,BOS,4,1,27270,139,-3,NW
1982-07-10,0,BOS,4,5,26022,148,1,W
1982-07-11,0,BOS,7,3,26910,146,-4,NW
1982-07-15,0,BOS,3,5,29186,146,2,W
1982-07-16,0,BOS,3,7,30811,144,4,W
1982-07-17,0,BOS,4,8,30962,171,4,W
1982-07-18,0,BOS,9,0,28072,153,-9,NW
1982-07-19,0,BOS,5,9,19218,167,4,W
1982-07-21,1,BOS,6,3,0,156,-3,NW
1982-07-21,2,BOS,1,6,30225,140,5,W
1982-07-26,0,BOS,2,3,22261,133,1,W
1982-07-27,0,BOS,3,1,27077,122,-2,NW
1982-07-28,0,BOS,7,9,18627,146,2,W
1982-08-06,0,BOS,6,3,33010,168,-3,NW
1982-08-07,0,BOS,7,3,33595,159,-4,NW
1982-08-08,0,BOS,6,12,27312,184,6,W
1982-08-13,0,BOS,2,5,32935,134,3,W
1982-08-14,0,BOS,5,2,31343,174,-3,NW
1982-08-15,0,BOS,0,8,30675,135,8,W
1982-08-16,0,BOS,4,9,34746,181,5,W
1982-08-26,1,BOS,10,1,19902,156,-9,NW
1982-08-26,2,BOS,3,4,31406,130,1,W
1982-08-27,0,BOS,7,6,32755,155,-1,NW
1982-08-28,0,BOS,6,7,34772,200,1,W
1982-08-29,0,BOS,3,9,32356,157,6,W
1982-08-30,0,BOS,7,9,24128,160,2,W
1982-08-31,0,BOS,0,4,23550,114,4,W
1982-09-01,0,BOS,4,7,18489,183,3,W
1982-09-03,0,BOS,8,10,22586,180,2,W
1982-09-04,0,BOS,4,3,21744,167,-1,NW
1982-09-05,0,BOS,5,6,22717,183,1,W
1982-09-10,0,BOS,6,4,27199,164,-2,NW
1982-09-11,0,BOS,3,13,25451,183,10,W
1982-09-12,0,BOS,7,10,25154,152,3,W
1982-09-13,1,BOS,3,1,0,164,-2,NW
1982-09-13,2,BOS,4,3,19717,181,-1,NW
1982-09-14,0,BOS,1,12,15765,193,11,W
1982-09-15,0,BOS,7,4,15264,177,-3,NW
1982-09-24,0,BOS,2,4,32077,142,2,W
1982-09-25,0,BOS,6,2,33559,154,-4,NW
1982-09-26,0,BOS,2,5,32793,152,3,W
1982-09-27,0,BOS,10,3,21359,169,-7,NW
1982-09-28,0,BOS,9,3,19356,165,-6,NW
1982-09-29,0,BOS,6,3,18390,187,-3,NW
1982-09-30,0,BOS,4,9,21268,181,5,W
1983-04-05,0,BOS,7,1,33852,139,-6,NW
1983-04-07,0,BOS,4,7,9603,126,3,W
1983-04-15,0,BOS,1,4,13553,140,3,W
1983-04-16,0,BOS,1,2,13534,149,1,W
1983-04-17,0,BOS,1,0,16038,225,-1,NW
1983-04-18,0,BOS,14,0,31644,169,-14,NW
1983-04-20,0,BOS,4,5,17302,137,1,W
1983-05-03,0,BOS,1,3,13189,142,2,W
1983-05-04,0,BOS,1,7,14164,146,6,W
1983-05-06,0,BOS,4,6,18241,152,2,W
1983-05-07,0,BOS,0,8,24076,140,8,W
1983-05-08,0,BOS,4,2,16997,157,-2,NW
1983-05-09,0,BOS,2,8,16148,137,6,W
1983-05-10,0,BOS,6,5,15775,160,-1,NW
1983-05-11,0,BOS,3,1,16978,122,-2,NW
1983-05-17,0,BOS,1,4,17063,144,3,W
1983-05-18,0,BOS,2,1,17374,139,-1,NW
1983-05-19,0,BOS,1,4,14173,132,3,W
1983-05-20,0,BOS,10,4,19332,158,-6,NW
1983-05-21,0,BOS,4,11,24856,146,7,W
1983-05-22,0,BOS,4,3,23496,195,-1,NW
1983-05-30,0,BOS,6,4,20023,183,-2,NW
1983-05-31,0,BOS,1,2,15135,143,1,W
1983-06-01,0,BOS,8,3,17751,152,-5,NW
1983-06-06,0,BOS,11,6,23961,181,-5,NW
1983-06-07,0,BOS,4,2,18015,122,-2,NW
1983-06-08,0,BOS,6,3,17593,162,-3,NW
1983-06-09,0,BOS,8,2,18904,155,-6,NW
1983-06-10,0,BOS,3,0,30195,119,-3,NW
1983-06-11,0,BOS,10,6,32522,191,-4,NW
1983-06-12,0,BOS,6,7,28656,165,1,W
1983-06-20,0,BOS,3,6,18417,141,3,W
1983-06-21,0,BOS,3,1,19738,159,-2,NW
1983-06-22,0,BOS,9,4,19755,139,-5,NW
1983-06-23,0,BOS,5,4,20591,173,-1,NW
1983-06-24,0,BOS,4,5,34178,163,1,W
1983-06-25,0,BOS,4,1,33971,169,-3,NW
1983-06-26,0,BOS,5,12,33841,171,7,W
1983-07-08,0,BOS,9,3,33878,160,-6,NW
1983-07-09,0,BOS,3,10,32667,137,7,W
1983-07-10,0,BOS,5,3,32142,138,-2,NW
1983-07-11,0,BOS,5,6,19384,214,1,W
1983-07-12,0,BOS,3,2,18846,133,-1,NW
1983-07-13,0,BOS,6,4,18708,167,-2,NW
1983-07-14,0,BOS,4,9,24914,164,5,W
1983-07-15,0,BOS,7,10,25243,172,3,W
1983-07-16,0,BOS,12,5,28537,179,-7,NW
1983-07-17,0,BOS,13,9,24326,214,-4,NW
1983-07-29,0,BOS,11,5,33250,191,-6,NW
1983-07-30,0,BOS,5,10,30900,185,5,W
1983-07-31,0,BOS,7,5,29800,180,-2,NW
1983-08-01,0,BOS,6,2,29620,172,-4,NW
1983-08-08,0,BOS,12,7,21887,201,-5,NW
1983-08-09,0,BOS,4,6,21022,128,2,W
1983-08-10,0,BOS,2,4,22679,143,2,W
1983-08-13,1,BOS,5,4,0,186,-1,NW
1983-08-13,2,BOS,3,12,33896,155,9,W
1983-08-14,1,BOS,3,4,0,148,1,W
1983-08-14,2,BOS,6,3,33514,161,-3,NW
1983-08-19,0,BOS,8,7,27386,184,-1,NW
1983-08-20,0,BOS,2,5,29173,137,3,W
1983-08-21,0,BOS,7,3,31159,149,-4,NW
1983-08-22,0,BOS,2,4,26351,150,2,W
1983-09-01,1,BOS,11,0,0,133,-11,NW
1983-09-01,2,BOS,3,9,18860,147,6,W
1983-09-02,0,BOS,1,5,24572,127,4,W
1983-09-03,0,BOS,9,6,21904,188,-3,NW
1983-09-04,0,BOS,2,6,21696,156,4,W
1983-09-13,1,BOS,7,4,0,198,-3,NW
1983-09-13,2,BOS,7,1,17440,145,-6,NW
1983-09-14,0,BOS,5,0,16414,163,-5,NW
1983-09-15,0,BOS,1,7,16994,152,6,W
1983-09-16,0,BOS,1,6,20156,173,5,W
1983-09-17,0,BOS,2,3,23294,133,1,W
1983-09-18,0,BOS,9,6,21854,169,-3,NW
1983-09-19,0,BOS,3,5,24447,138,2,W
1983-09-20,0,BOS,3,2,24023,152,-1,NW
1983-09-21,0,BOS,1,3,23314,150,2,W
1983-09-30,0,BOS,0,10,18928,154,10,W
1983-10-01,0,BOS,3,1,33491,125,-2,NW
1983-10-02,0,BOS,1,3,33491,158,2,W
1984-04-13,0,BOS,13,9,35179,191,-4,NW
1984-04-17,0,BOS,8,4,13293,155,-4,NW
1984-04-18,0,BOS,4,3,12052,141,-1,NW
1984-04-19,0,BOS,7,4,10926,144,-3,NW
1984-04-20,0,BOS,1,3,15523,157,2,W
1984-04-21,0,BOS,5,2,16373,174,-3,NW
1984-04-22,0,BOS,8,12,14025,159,4,W
1984-04-23,0,BOS,0,2,12912,90,2,W
1984-04-24,0,BOS,8,7,12330,185,-1,NW
1984-04-25,0,BOS,1,2,11748,149,1,W
1984-04-26,0,BOS,6,5,14092,181,-1,NW
1984-05-04,0,BOS,5,3,17550,174,-2,NW
1984-05-05,0,BOS,8,5,23809,167,-3,NW
1984-05-06,0,BOS,1,3,23978,125,2,W
1984-05-21,0,BOS,3,6,14315,152,3,W
1984-05-22,0,BOS,1,7,16424,161,6,W
1984-05-23,0,BOS,5,4,12819,175,-1,NW
1984-05-25,0,BOS,8,5,20657,165,-3,NW
1984-05-26,0,BOS,11,7,20133,181,-4,NW
1984-05-27,0,BOS,0,6,27355,141,6,W
1984-05-30,0,BOS,0,2,12642,119,2,W
1984-06-07,0,BOS,6,3,19131,169,-3,NW
1984-06-08,0,BOS,3,11,23104,146,8,W
1984-06-09,0,BOS,6,15,29488,188,9,W
1984-06-10,0,BOS,4,5,24431,158,1,W
1984-06-11,0,BOS,6,9,25036,187,3,W
1984-06-12,0,BOS,8,9,20794,189,1,W
1984-06-13,0,BOS,4,2,25306,147,-2,NW
1984-06-14,0,BOS,12,11,28790,212,-1,NW
1984-06-19,0,BOS,9,7,23230,175,-2,NW
1984-06-20,0,BOS,4,1,23736,131,-3,NW
1984-06-21,0,BOS,5,2,18372,126,-3,NW
1984-06-22,0,BOS,1,8,23167,156,7,W
1984-06-23,0,BOS,9,3,27689,165,-6,NW
1984-06-24,0,BOS,3,5,32521,189,2,W
1984-06-28,0,BOS,6,9,16715,241,3,W
1984-06-29,0,BOS,5,3,17955,162,-2,NW
1984-06-30,0,BOS,2,1,21078,132,-1,NW
1984-07-01,0,BOS,1,0,18933,151,-1,NW
1984-07-02,0,BOS,9,6,17679,218,-3,NW
1984-07-03,0,BOS,5,6,15793,223,1,W
1984-07-04,0,BOS,9,13,16571,205,4,W
1984-07-05,0,BOS,7,12,19885,154,5,W
1984-07-06,0,BOS,7,8,29655,178,1,W
1984-07-08,1,BOS,2,3,0,165,1,W
1984-07-08,2,BOS,4,0,34682,152,-4,NW
1984-07-24,0,BOS,2,3,30437,143,1,W
1984-07-25,0,BOS,2,3,31229,214,1,W
1984-07-26,0,BOS,0,7,28753,154,7,W
1984-08-03,0,BOS,4,3,24615,171,-1,NW
1984-08-04,0,BOS,2,5,27515,148,3,W
1984-08-05,0,BOS,2,4,23190,144,2,W
1984-08-06,1,BOS,9,7,0,197,-2,NW
1984-08-06,2,BOS,2,10,31055,175,8,W
1984-08-07,1,BOS,7,12,0,169,5,W
1984-08-07,2,BOS,7,5,32120,213,-2,NW
1984-08-08,0,BOS,0,8,32563,148,8,W
1984-08-16,0,BOS,5,7,9293,175,2,W
1984-08-17,0,BOS,6,5,25629,178,-1,NW
1984-08-18,1,BOS,6,4,0,161,-2,NW
1984-08-18,2,BOS,3,1,30567,142,-2,NW
1984-08-19,0,BOS,4,5,23763,156,1,W
1984-08-20,0,BOS,8,5,20251,159,-3,NW
1984-08-21,0,BOS,1,11,21143,150,10,W
1984-08-22,0,BOS,6,2,23287,165,-4,NW
1984-08-24,0,BOS,6,7,20812,158,1,W
1984-08-25,0,BOS,6,11,22495,176,5,W
1984-08-26,0,BOS,2,4,23292,181,2,W
1984-09-07,0,BOS,4,2,33291,160,-2,NW
1984-09-08,0,BOS,12,6,34607,207,-6,NW
1984-09-09,0,BOS,1,10,33655,153,9,W
1984-09-10,0,BOS,7,4,13693,177,-3,NW
1984-09-11,0,BOS,14,6,14768,166,-8,NW
1984-09-12,0,BOS,4,5,14754,151,1,W
1984-09-24,0,BOS,9,8,13328,191,-1,NW
1984-09-25,0,BOS,6,14,14259,177,8,W
1984-09-26,0,BOS,8,4,13065,165,-4,NW
1984-09-27,0,BOS,3,4,14663,144,1,W
1984-09-28,0,BOS,4,5,19300,132,1,W
1984-09-29,0,BOS,6,3,23655,159,-3,NW
1984-09-30,0,BOS,5,3,23628,169,-2,NW
1985-04-08,0,BOS,2,9,34282,153,7,W
1985-04-10,0,BOS,5,14,19615,176,9,W
1985-04-11,0,BOS,4,6,19060,180,2,W
1985-04-13,0,BOS,2,7,24718,144,5,W
1985-04-14,0,BOS,11,6,18401,182,-5,NW
1985-04-15,0,BOS,6,5,33535,230,-1,NW
1985-04-26,0,BOS,2,5,26647,160,3,W
1985-04-27,0,BOS,5,4,24430,183,-1,NW
1985-04-28,0,BOS,5,2,23822,163,-3,NW
1985-05-07,0,BOS,4,6,17788,189,2,W
1985-05-08,0,BOS,1,6,17052,177,5,W
1985-05-10,0,BOS,4,5,23517,206,1,W
1985-05-11,0,BOS,12,1,28031,178,-11,NW
1985-05-12,0,BOS,5,3,18711,167,-2,NW
1985-05-14,0,BOS,5,0,14463,182,-5,NW
1985-05-15,0,BOS,7,1,16981,185,-6,NW
1985-05-27,0,BOS,2,9,18496,178,7,W
1985-05-29,0,BOS,0,7,17989,146,7,W
1985-05-30,0,BOS,7,8,13234,198,1,W
1985-05-31,0,BOS,3,1,19623,156,-2,NW
1985-06-01,0,BOS,0,6,25346,166,6,W
1985-06-02,0,BOS,3,12,21387,198,9,W
1985-06-03,0,BOS,5,6,15180,161,1,W
1985-06-04,0,BOS,0,5,16336,157,5,W
1985-06-10,0,BOS,2,4,18967,154,2,W
1985-06-11,0,BOS,5,3,22243,184,-2,NW
1985-06-12,0,BOS,2,7,15155,178,5,W
1985-06-13,0,BOS,7,8,22459,200,1,W
1985-06-14,0,BOS,1,4,33809,176,3,W
1985-06-15,0,BOS,5,7,35664,167,2,W
1985-06-16,0,BOS,6,7,27700,196,1,W
1985-06-24,0,BOS,2,9,31777,172,7,W
1985-06-25,0,BOS,3,0,31359,182,-3,NW
1985-06-26,0,BOS,3,0,29960,158,-3,NW
1985-06-28,0,BOS,1,6,31829,168,5,W
1985-06-29,0,BOS,16,4,32976,180,-12,NW
1985-06-30,0,BOS,3,0,35643,151,-3,NW
1985-07-18,0,BOS,1,10,29194,163,9,W
1985-07-19,0,BOS,3,2,31368,144,-1,NW
1985-07-20,0,BOS,5,3,33147,172,-2,NW
1985-07-21,0,BOS,4,8,28636,183,4,W
1985-07-22,0,BOS,4,6,22076,189,2,W
1985-07-23,0,BOS,2,3,22038,162,1,W
1985-07-24,0,BOS,5,6,27034,160,1,W
1985-07-25,0,BOS,3,5,24471,189,2,W
1985-07-26,0,BOS,2,6,20512,164,4,W
1985-07-27,0,BOS,10,3,28807,175,-7,NW
1985-07-28,0,BOS,7,2,26708,191,-5,NW
1985-07-30,0,BOS,7,5,29610,190,-2,NW
1985-07-31,0,BOS,1,1,19777,140,0,NW
1985-08-01,1,BOS,7,2,0,179,-5,NW
1985-08-01,2,BOS,3,4,25216,175,1,W
1985-08-09,0,BOS,10,6,33739,198,-4,NW
1985-08-10,0,BOS,7,3,33009,195,-4,NW
1985-08-11,0,BOS,5,3,33685,197,-2,NW
1985-08-12,0,BOS,3,2,22843,159,-1,NW
1985-08-13,0,BOS,6,3,23189,183,-3,NW
1985-08-14,0,BOS,3,16,22870,176,13,W
1985-08-20,0,BOS,3,1,17420,166,-2,NW
1985-08-21,0,BOS,5,3,18447,161,-2,NW
1985-08-22,0,BOS,4,8,17074,163,4,W
1985-08-23,0,BOS,5,2,22041,160,-3,NW
1985-08-24,0,BOS,1,0,30463,153,-1,NW
1985-09-05,1,BOS,6,13,0,190,7,W
1985-09-05,2,BOS,9,5,16989,185,-4,NW
1985-09-07,1,BOS,9,11,0,197,2,W
1985-09-07,2,BOS,4,7,19953,188,3,W
1985-09-08,0,BOS,1,8,18511,188,7,W
1985-09-10,1,BOS,7,5,0,185,-2,NW
1985-09-10,2,BOS,3,5,14294,160,2,W
1985-09-11,0,BOS,1,4,15264,156,3,W
1985-09-12,0,BOS,3,1,15014,160,-2,NW
1985-09-17,0,BOS,5,6,17274,173,1,W
1985-09-18,0,BOS,1,13,17598,169,12,W
1985-09-20,0,BOS,6,2,23442,165,-4,NW
1985-09-21,0,BOS,6,7,25618,207,1,W
1985-09-22,0,BOS,2,6,23847,169,4,W
1985-09-23,0,BOS,2,1,14089,166,-1,NW
1985-10-04,0,BOS,8,7,13128,240,-1,NW
1985-10-05,0,BOS,3,2,12754,146,-1,NW
1985-10-06,0,BOS,9,6,17129,177,-3,NW
1986-04-14,0,BOS,8,2,34764,164,-6,NW
1986-04-16,0,BOS,1,0,11164,125,-1,NW
1986-04-17,0,BOS,2,6,10583,139,4,W
1986-04-18,0,BOS,1,2,17978,126,1,W
1986-04-19,0,BOS,2,3,20667,147,1,W
1986-04-20,0,BOS,2,6,23441,156,4,W
1986-04-21,0,BOS,5,4,30487,197,-1,NW
1986-04-22,0,BOS,4,6,16763,175,2,W
1986-04-23,0,BOS,3,1,13988,194,-2,NW
1986-04-29,0,BOS,1,3,13414,159,2,W
1986-04-30,0,BOS,4,9,13161,197,5,W
1986-05-01,0,BOS,2,12,13109,143,10,W
1986-05-02,0,BOS,4,1,17720,144,-3,NW
1986-05-03,0,BOS,3,4,20046,181,1,W
1986-05-04,0,BOS,1,4,25190,147,3,W
1986-05-05,0,BOS,0,3,16886,155,3,W
1986-05-06,0,BOS,6,2,14072,170,-4,NW
1986-05-16,0,BOS,4,1,23673,153,-3,NW
1986-05-17,0,BOS,2,8,31168,171,6,W
1986-05-18,0,BOS,4,5,26572,222,1,W
1986-05-19,0,BOS,7,8,18428,190,1,W
1986-05-20,0,BOS,7,17,20880,196,10,W
1986-05-21,0,BOS,2,3,16018,163,1,W
1986-06-02,0,BOS,1,3,20803,188,2,W
1986-06-03,0,BOS,1,5,17432,166,4,W
1986-06-04,0,BOS,4,6,25681,155,2,W
1986-06-13,0,BOS,3,5,29927,178,2,W
1986-06-14,0,BOS,2,0,33784,159,-2,NW
1986-06-15,0,BOS,7,3,33632,177,-4,NW
1986-06-20,0,BOS,14,3,34826,199,-11,NW
1986-06-21,0,BOS,2,7,35707,181,5,W
1986-06-22,0,BOS,4,0,33816,157,-4,NW
1986-06-23,0,BOS,11,3,35355,204,-8,NW
1986-06-24,0,BOS,8,1,34382,185,-7,NW
1986-06-25,0,BOS,4,5,35015,168,1,W
1986-06-30,0,BOS,9,10,30770,231,1,W
1986-07-01,0,BOS,7,9,32729,189,2,W
1986-07-02,0,BOS,4,2,27493,179,-2,NW
1986-07-03,0,BOS,8,5,21123,201,-3,NW
1986-07-04,0,BOS,5,6,19237,184,1,W
1986-07-05,0,BOS,9,5,26224,175,-4,NW
1986-07-06,0,BOS,3,7,27625,163,4,W
1986-07-07,0,BOS,6,4,27347,200,-2,NW
1986-07-08,0,BOS,7,8,25680,197,1,W
1986-07-09,0,BOS,6,7,26019,167,1,W
1986-07-10,0,BOS,7,8,31305,267,1,W
1986-07-11,0,BOS,5,0,35497,170,-5,NW
1986-07-12,0,BOS,2,3,32932,161,1,W
1986-07-13,0,BOS,12,3,29374,187,-9,NW
1986-08-01,0,BOS,3,5,35716,135,2,W
1986-08-02,0,BOS,13,2,34941,185,-11,NW
1986-08-03,0,BOS,3,5,33682,146,2,W
1986-08-04,0,BOS,1,0,34780,173,-1,NW
1986-08-05,0,BOS,3,1,35236,156,-2,NW
1986-08-06,0,BOS,0,9,33517,151,9,W
1986-08-15,0,BOS,5,8,35525,185,3,W
1986-08-16,0,BOS,12,6,34806,195,-6,NW
1986-08-17,0,BOS,5,7,34704,181,2,W
1986-08-29,0,BOS,7,3,34004,173,-4,NW
1986-08-30,0,BOS,3,7,30467,146,4,W
1986-08-31,0,BOS,3,4,29995,192,1,W
1986-09-01,0,BOS,4,6,26196,185,2,W
1986-09-02,0,BOS,6,8,20699,184,2,W
1986-09-03,0,BOS,3,4,21668,162,1,W
1986-09-05,0,BOS,2,12,30546,176,10,W
1986-09-06,0,BOS,2,3,31236,167,1,W
1986-09-07,0,BOS,0,9,30359,151,9,W
1986-09-16,1,BOS,1,2,0,155,1,W
1986-09-16,2,BOS,3,9,31272,185,6,W
1986-09-17,0,BOS,1,4,26976,146,3,W
1986-09-18,0,BOS,1,7,25592,153,6,W
1986-09-26,0,BOS,1,0,33657,241,-1,NW
1986-09-27,0,BOS,0,2,33358,134,2,W
1986-09-28,0,BOS,3,12,32929,189,9,W
1986-09-29,0,BOS,5,7,27372,182,2,W
1986-09-30,0,BOS,6,3,26339,203,-3,NW
1986-10-01,0,BOS,7,11,28513,201,4,W
1986-10-02,0,BOS,6,1,31697,190,-5,NW
1986-10-04,1,BOS,5,3,0,178,-2,NW
1986-10-04,2,BOS,3,1,34290,152,-2,NW
1986-10-05,0,BOS,7,0,32735,145,-7,NW
1987-04-10,0,BOS,0,3,33679,124,3,W
1987-04-11,0,BOS,11,1,33365,192,-10,NW
1987-04-12,0,BOS,3,8,27521,160,5,W
1987-04-14,0,BOS,1,4,13740,178,3,W
1987-04-15,0,BOS,4,5,16870,172,1,W
1987-04-20,0,BOS,10,2,35486,146,-8,NW
1987-04-21,0,BOS,0,8,29082,174,8,W
1987-04-22,0,BOS,0,1,24589,144,1,W
1987-05-05,0,BOS,0,6,16444,166,6,W
1987-05-06,0,BOS,2,6,19154,176,4,W
1987-05-08,0,BOS,4,6,32072,169,2,W
1987-05-09,0,BOS,8,1,34205,164,-7,NW
1987-05-10,0,BOS,0,7,32121,136,7,W
1987-05-11,0,BOS,4,3,21410,152,-1,NW
1987-05-12,0,BOS,2,3,19193,175,1,W
1987-05-13,0,BOS,5,4,20270,177,-1,NW
1987-05-22,0,BOS,4,3,31894,159,-1,NW
1987-05-23,0,BOS,9,1,31263,170,-8,NW
1987-05-24,0,BOS,4,1,31369,180,-3,NW
1987-05-25,0,BOS,6,10,19858,188,4,W
1987-05-26,0,BOS,5,6,18493,175,1,W
1987-05-27,0,BOS,0,1,22906,161,1,W
1987-05-28,0,BOS,8,12,22305,228,4,W
1987-06-01,0,BOS,9,5,20221,176,-4,NW
1987-06-02,0,BOS,5,6,16910,213,1,W
1987-06-03,0,BOS,6,7,20638,217,1,W
1987-06-04,0,BOS,5,8,24660,185,3,W
1987-06-05,0,BOS,4,2,33827,186,-2,NW
1987-06-06,0,BOS,5,3,33902,291,-2,NW
1987-06-07,0,BOS,18,8,33254,222,-10,NW
1987-06-19,0,BOS,10,5,33835,302,-5,NW
1987-06-20,0,BOS,4,9,33134,163,5,W
1987-06-21,0,BOS,2,4,33012,158,2,W
1987-06-22,0,BOS,2,5,29546,127,3,W
1987-06-23,0,BOS,5,9,31104,214,4,W
1987-06-24,0,BOS,7,8,34376,202,1,W
1987-06-29,0,BOS,3,14,31139,168,11,W
1987-06-30,0,BOS,9,13,29433,213,4,W
1987-07-01,0,BOS,2,6,33075,181,4,W
1987-07-16,0,BOS,6,3,34861,168,-3,NW
1987-07-17,0,BOS,11,6,34543,233,-5,NW
1987-07-18,0,BOS,3,5,34720,183,2,W
1987-07-19,0,BOS,5,3,34114,242,-2,NW
1987-07-20,0,BOS,3,2,27322,171,-1,NW
1987-07-21,0,BOS,0,3,30301,148,3,W
1987-07-22,0,BOS,6,5,31729,197,-1,NW
1987-07-24,0,BOS,4,5,29999,151,1,W
1987-07-25,0,BOS,5,11,32040,177,6,W
1987-07-26,0,BOS,1,11,31974,181,10,W
1987-08-07,0,BOS,3,4,34946,173,1,W
1987-08-08,0,BOS,3,8,34622,174,5,W
1987-08-09,0,BOS,8,3,34009,176,-5,NW
1987-08-10,0,BOS,1,9,30606,196,8,W
1987-08-11,0,BOS,8,3,32555,187,-5,NW
1987-08-12,0,BOS,10,4,33403,176,-6,NW
1987-08-14,1,BOS,3,9,0,190,6,W
1987-08-14,2,BOS,9,4,33840,165,-5,NW
1987-08-15,0,BOS,6,7,31189,210,1,W
1987-08-16,0,BOS,2,12,31438,166,10,W
1987-08-21,0,BOS,3,11,33490,192,8,W
1987-08-22,0,BOS,5,6,29794,160,1,W
1987-08-23,0,BOS,4,6,32956,163,2,W
1987-08-24,0,BOS,6,3,25136,198,-3,NW
1987-08-25,0,BOS,3,7,27345,157,4,W
1987-08-26,0,BOS,5,3,29947,169,-2,NW
1987-09-04,0,BOS,2,5,23378,175,3,W
1987-09-05,0,BOS,15,2,28638,197,-13,NW
1987-09-06,0,BOS,3,1,25520,156,-2,NW
1987-09-07,0,BOS,9,5,32544,163,-4,NW
1987-09-08,0,BOS,6,8,29468,195,2,W
1987-09-09,0,BOS,3,5,32025,186,2,W
1987-09-10,0,BOS,4,5,19639,184,1,W
1987-09-11,0,BOS,3,9,24938,155,6,W
1987-09-12,0,BOS,3,4,27409,167,1,W
1987-09-21,0,BOS,4,9,20376,191,5,W
1987-09-22,0,BOS,8,5,20189,200,-3,NW
1987-09-23,0,BOS,4,0,23798,140,-4,NW
1987-10-02,0,BOS,2,3,20077,201,1,W
1987-10-03,0,BOS,8,4,21962,172,-4,NW
1987-10-04,0,BOS,0,4,25454,152,4,W
1988-04-04,0,BOS,5,3,34781,189,-2,NW
1988-04-06,0,BOS,5,6,16965,178,1,W
1988-04-07,0,BOS,11,6,13807,179,-5,NW
1988-04-12,0,BOS,1,3,12045,161,2,W
1988-04-13,0,BOS,3,6,14114,172,3,W
1988-04-14,0,BOS,0,2,15693,156,2,W
1988-04-15,0,BOS,3,2,12369,183,-1,NW
1988-04-16,0,BOS,2,0,25936,165,-2,NW
1988-04-17,0,BOS,2,15,32243,185,13,W
1988-04-18,0,BOS,3,4,33976,180,1,W
1988-04-29,0,BOS,5,6,32022,224,1,W
1988-04-30,0,BOS,3,8,32708,178,5,W
1988-05-01,0,BOS,2,0,31124,155,-2,NW
1988-05-02,0,BOS,2,0,20400,180,-2,NW
1988-05-03,0,BOS,9,3,21602,183,-6,NW
1988-05-04,0,BOS,6,2,21191,160,-4,NW
1988-05-05,0,BOS,3,16,24135,157,13,W
1988-05-13,0,BOS,8,14,29582,163,6,W
1988-05-14,0,BOS,0,3,33846,164,3,W
1988-05-15,0,BOS,11,7,33109,201,-4,NW
1988-05-16,0,BOS,3,0,24642,165,-3,NW
1988-05-17,0,BOS,12,7,28407,179,-5,NW
1988-05-18,0,BOS,1,4,24683,175,3,W
1988-05-20,0,BOS,4,2,31032,196,-2,NW
1988-05-21,0,BOS,4,8,32180,187,4,W
1988-05-22,0,BOS,4,12,32678,166,8,W
1988-06-02,0,BOS,5,4,32144,183,-1,NW
1988-06-03,0,BOS,6,3,32292,171,-3,NW
1988-06-04,0,BOS,10,2,33067,176,-8,NW
1988-06-05,0,BOS,12,4,33756,233,-8,NW
1988-06-13,0,BOS,12,6,34288,177,-6,NW
1988-06-14,0,BOS,3,7,33367,186,4,W
1988-06-15,0,BOS,3,8,33870,181,5,W
1988-06-24,0,BOS,6,2,35333,171,-4,NW
1988-06-25,0,BOS,3,10,34573,166,7,W
1988-06-26,0,BOS,1,10,34374,163,9,W
1988-06-27,0,BOS,5,9,33318,196,4,W
1988-06-28,0,BOS,1,6,34661,156,5,W
1988-06-29,0,BOS,1,5,35035,171,4,W
1988-07-15,1,BOS,1,3,0,146,2,W
1988-07-15,2,BOS,4,7,35412,199,3,W
1988-07-16,0,BOS,6,7,34466,192,1,W
1988-07-17,0,BOS,8,10,34181,201,2,W
1988-07-18,0,BOS,5,6,33397,196,1,W
1988-07-19,0,BOS,0,5,32036,145,5,W
1988-07-20,0,BOS,7,9,35313,216,2,W
1988-07-21,0,BOS,1,6,32049,157,5,W
1988-07-22,0,BOS,3,4,33477,171,1,W
1988-07-23,0,BOS,5,11,35129,201,6,W
1988-07-24,0,BOS,2,3,33394,165,1,W
1988-07-29,1,BOS,4,6,0,171,2,W
1988-07-29,2,BOS,4,5,35169,175,1,W
1988-07-30,0,BOS,2,3,33964,165,1,W
1988-07-31,0,BOS,0,5,33527,146,5,W
1988-08-02,0,BOS,2,7,35462,153,5,W
1988-08-03,0,BOS,4,5,34380,184,1,W
1988-08-12,0,BOS,4,9,34732,178,5,W
1988-08-13,0,BOS,4,16,33601,201,12,W
1988-08-14,0,BOS,18,6,33757,199,-12,NW
1988-08-16,0,BOS,7,0,33924,165,-7,NW
1988-08-17,0,BOS,2,7,31548,180,5,W
1988-08-18,0,BOS,6,1,33944,180,-5,NW
1988-08-19,0,BOS,6,7,33993,184,1,W
1988-08-20,0,BOS,5,7,34372,202,2,W
1988-08-21,0,BOS,5,4,33282,200,-1,NW
1988-08-22,0,BOS,2,6,33828,154,4,W
1988-08-23,0,BOS,2,10,34313,187,8,W
1988-08-24,0,BOS,4,3,32522,192,-1,NW
1988-09-09,0,BOS,4,7,33349,165,3,W
1988-09-10,0,BOS,0,6,34099,143,6,W
1988-09-11,0,BOS,4,2,33154,171,-2,NW
1988-09-12,0,BOS,1,6,32619,163,5,W
1988-09-13,0,BOS,4,6,32842,179,2,W
1988-09-14,0,BOS,3,4,32745,153,1,W
1988-09-15,0,BOS,5,3,35320,213,-2,NW
1988-09-16,0,BOS,4,7,35226,179,3,W
1988-09-17,0,BOS,1,3,35051,176,2,W
1988-09-18,0,BOS,4,9,35146,185,5,W
1988-09-26,0,BOS,11,1,33953,185,-10,NW
1988-09-27,0,BOS,15,9,34442,192,-6,NW
1988-09-28,0,BOS,1,0,34873,142,-1,NW
1989-04-10,0,BOS,2,5,32909,175,3,W
1989-04-12,0,BOS,10,6,19210,183,-4,NW
1989-04-13,0,BOS,1,9,18518,164,8,W
1989-04-14,0,BOS,4,7,24460,173,3,W
1989-04-15,0,BOS,12,4,28457,199,-8,NW
1989-04-17,0,BOS,4,6,32923,207,2,W
1989-04-21,0,BOS,7,4,31766,173,-3,NW
1989-04-22,0,BOS,7,3,33048,164,-4,NW
1989-04-23,0,BOS,10,0,33116,153,-10,NW
1989-04-25,0,BOS,0,11,21326,166,11,W
1989-04-26,0,BOS,4,5,22948,172,1,W
1989-04-27,0,BOS,3,1,23830,309,-2,NW
1989-05-05,0,BOS,6,7,32555,222,1,W
1989-05-06,0,BOS,0,7,31508,159,7,W
1989-05-07,0,BOS,5,9,33067,200,4,W
1989-05-08,0,BOS,4,2,23618,157,-2,NW
1989-05-09,0,BOS,6,2,25951,182,-4,NW
1989-05-23,0,BOS,5,6,28069,195,1,W
1989-05-24,0,BOS,5,6,23784,182,1,W
1989-05-25,0,BOS,0,10,26335,176,10,W
1989-05-26,0,BOS,5,0,32417,146,-5,NW
1989-05-28,0,BOS,3,0,34311,143,-3,NW
1989-05-29,0,BOS,2,3,33344,156,1,W
1989-05-30,0,BOS,4,2,31407,179,-2,NW
1989-05-31,0,BOS,3,4,33510,237,1,W
1989-06-02,0,BOS,7,2,33584,185,-5,NW
1989-06-03,0,BOS,10,2,33942,185,-8,NW
1989-06-04,0,BOS,13,11,33760,276,-2,NW
1989-06-13,0,BOS,7,8,30969,227,1,W
1989-06-14,0,BOS,7,3,32656,163,-4,NW
1989-06-20,0,BOS,3,6,34443,175,3,W
1989-06-21,0,BOS,10,3,34338,205,-7,NW
1989-06-22,0,BOS,9,1,34000,170,-8,NW
1989-06-23,0,BOS,10,0,33548,164,-10,NW
1989-06-24,1,BOS,2,6,33346,197,4,W
1989-06-24,2,BOS,2,11,18819,176,9,W
1989-06-25,0,BOS,7,0,34007,163,-7,NW
1989-07-04,0,BOS,4,3,26120,182,-1,NW
1989-07-06,0,BOS,4,5,33538,202,1,W
1989-07-07,0,BOS,4,6,33368,142,2,W
1989-07-08,0,BOS,7,5,33923,175,-2,NW
1989-07-09,0,BOS,5,10,33521,191,5,W
1989-07-21,0,BOS,1,0,34925,163,-1,NW
1989-07-22,0,BOS,10,6,34899,206,-4,NW
1989-07-23,0,BOS,2,8,34519,154,6,W
1989-07-25,0,BOS,0,10,34944,149,10,W
1989-07-26,0,BOS,7,4,34681,178,-3,NW
1989-07-27,0,BOS,2,7,34223,163,5,W
1989-07-31,0,BOS,6,9,33826,198,3,W
1989-08-01,1,BOS,3,5,35111,210,2,W
1989-08-01,2,BOS,2,6,34901,178,4,W
1989-08-02,0,BOS,9,8,34970,216,-1,NW
1989-08-03,0,BOS,4,2,33992,156,-2,NW
1989-08-04,0,BOS,4,3,34154,157,-1,NW
1989-08-05,0,BOS,2,10,34090,153,8,W
1989-08-06,0,BOS,4,6,33935,173,2,W
1989-08-14,0,BOS,4,2,35058,167,-2,NW
1989-08-15,0,BOS,7,2,34800,209,-5,NW
1989-08-16,0,BOS,7,3,35310,210,-4,NW
1989-08-25,1,BOS,2,4,0,162,2,W
1989-08-25,2,BOS,3,11,35158,188,8,W
1989-08-26,0,BOS,2,5,34643,162,3,W
1989-08-27,0,BOS,1,7,34252,144,6,W
1989-08-28,0,BOS,3,6,33307,164,3,W
1989-08-29,1,BOS,4,8,0,166,4,W
1989-08-29,2,BOS,5,13,33987,174,8,W
1989-08-30,0,BOS,4,0,34182,163,-4,NW
1989-08-31,0,BOS,2,5,31737,183,3,W
1989-09-01,0,BOS,7,2,31581,160,-5,NW
1989-09-02,0,BOS,5,6,33615,190,1,W
1989-09-03,0,BOS,3,2,35035,160,-1,NW
1989-09-15,0,BOS,2,7,33533,188,5,W
1989-09-16,0,BOS,2,5,33778,152,3,W
1989-09-17,0,BOS,6,7,33148,192,1,W
1989-09-25,0,BOS,4,7,32759,181,3,W
1989-09-26,0,BOS,5,9,31932,162,4,W
1989-09-27,0,BOS,3,0,32685,172,-3,NW
1989-09-28,0,BOS,6,12,28954,164,6,W
1989-09-29,0,BOS,4,5,32906,170,1,W
1989-09-30,0,BOS,3,1,33243,141,-2,NW
1989-10-01,0,BOS,1,5,33027,110,4,W
1990-04-09,0,BOS,2,5,35199,167,3,W
1990-04-10,0,BOS,2,4,15352,174,2,W
1990-04-11,0,BOS,2,3,15369,204,1,W
1990-04-13,0,BOS,9,5,22731,220,-4,NW
1990-04-14,0,BOS,3,4,31571,192,1,W
1990-04-16,0,BOS,18,0,35478,194,-18,NW
1990-04-24,0,BOS,2,4,24362,180,2,W
1990-04-25,0,BOS,3,1,19843,177,-2,NW
1990-04-26,0,BOS,4,5,22601,195,1,W
1990-04-27,0,BOS,6,7,32912,206,1,W
1990-04-28,0,BOS,3,12,33989,170,9,W
1990-04-29,0,BOS,1,0,33237,181,-1,NW
1990-04-30,0,BOS,0,11,18540,149,11,W
1990-05-01,0,BOS,2,8,20786,186,6,W
1990-05-02,0,BOS,9,2,23977,177,-7,NW
1990-05-18,0,BOS,6,0,31779,189,-6,NW
1990-05-19,0,BOS,1,13,34145,171,12,W
1990-05-20,0,BOS,5,4,33141,193,-1,NW
1990-05-21,0,BOS,2,4,22359,145,2,W
1990-05-22,0,BOS,5,4,23193,199,-1,NW
1990-05-23,0,BOS,4,1,22468,167,-3,NW
1990-05-24,0,BOS,1,4,31982,139,3,W
1990-06-04,0,BOS,3,5,32125,164,2,W
1990-06-05,0,BOS,8,9,32919,182,1,W
1990-06-06,0,BOS,1,4,33385,143,3,W
1990-06-07,0,BOS,0,3,33454,131,3,W
1990-06-08,0,BOS,3,4,34222,180,1,W
1990-06-09,0,BOS,6,11,32991,184,5,W
1990-06-10,0,BOS,4,0,33961,153,-4,NW
1990-06-11,0,BOS,4,3,30404,263,-1,NW
1990-06-22,0,BOS,3,4,34711,160,1,W
1990-06-23,0,BOS,3,4,33767,199,1,W
1990-06-24,0,BOS,0,2,34125,152,2,W
1990-06-25,0,BOS,8,10,32591,194,2,W
1990-06-26,0,BOS,0,3,23244,159,3,W
1990-06-27,0,BOS,5,9,32961,179,4,W
1990-06-28,0,BOS,3,4,34547,166,1,W
1990-06-29,0,BOS,4,3,33083,210,-1,NW
1990-06-30,0,BOS,6,5,33184,183,-1,NW
1990-07-01,0,BOS,4,15,33825,176,11,W
1990-07-02,0,BOS,2,3,35096,170,1,W
1990-07-13,0,BOS,5,3,34701,184,-2,NW
1990-07-14,1,BOS,2,1,34287,195,-1,NW
1990-07-14,2,BOS,7,8,27163,178,1,W
1990-07-15,0,BOS,13,4,34054,183,-9,NW
1990-07-16,0,BOS,3,2,33445,163,-1,NW
1990-07-17,0,BOS,0,1,34113,152,1,W
1990-07-18,0,BOS,4,5,34838,141,1,W
1990-07-30,0,BOS,0,3,35599,176,3,W
1990-07-31,0,BOS,2,7,33033,177,5,W
1990-08-01,0,BOS,5,9,35522,185,4,W
1990-08-03,0,BOS,5,14,34713,183,9,W
1990-08-04,0,BOS,1,3,34857,180,2,W
1990-08-05,0,BOS,7,2,34581,185,-5,NW
1990-08-17,0,BOS,1,0,35107,156,-1,NW
1990-08-18,0,BOS,4,3,34131,197,-1,NW
1990-08-19,0,BOS,1,4,33365,196,3,W
1990-08-20,0,BOS,1,2,35060,198,1,W
1990-08-21,0,BOS,9,5,35022,208,-4,NW
1990-08-22,0,BOS,2,13,35189,186,11,W
1990-08-31,0,BOS,3,7,34464,172,4,W
1990-09-01,0,BOS,1,15,34482,179,14,W
1990-09-02,0,BOS,1,7,35458,168,6,W
1990-09-03,0,BOS,9,5,34692,202,-4,NW
1990-09-04,0,BOS,6,2,35408,198,-4,NW
1990-09-05,0,BOS,10,0,33156,169,-10,NW
1990-09-07,0,BOS,4,5,32868,206,1,W
1990-09-08,0,BOS,2,10,32680,173,8,W
1990-09-09,0,BOS,3,1,33923,189,-2,NW
1990-09-10,1,BOS,4,5,0,175,1,W
1990-09-10,2,BOS,6,1,28757,150,-5,NW
1990-09-11,0,BOS,4,2,27778,189,-2,NW
1990-09-12,0,BOS,1,6,29098,138,5,W
1990-09-25,0,BOS,5,2,28670,166,-3,NW
1990-09-26,0,BOS,2,7,28824,178,5,W
1990-09-28,0,BOS,6,7,35735,193,1,W
1990-09-29,0,BOS,5,7,35444,207,2,W
1990-09-30,0,BOS,10,5,34400,217,-5,NW
1990-10-01,0,BOS,3,4,31118,184,1,W
1990-10-02,0,BOS,3,2,33917,226,-1,NW
1990-10-03,0,BOS,1,3,33637,177,2,W
1991-04-11,0,BOS,6,4,34134,176,-2,NW
1991-04-13,0,BOS,0,4,33212,142,4,W
1991-04-14,0,BOS,6,0,33348,191,-6,NW
1991-04-15,0,BOS,1,0,33205,225,-1,NW
1991-04-16,0,BOS,2,5,25815,148,3,W
1991-04-17,0,BOS,2,6,24651,137,4,W
1991-04-18,0,BOS,0,1,29658,166,1,W
1991-04-22,0,BOS,4,6,25841,172,2,W
1991-04-23,0,BOS,0,3,29904,182,3,W
1991-04-24,0,BOS,6,1,28841,173,-5,NW
1991-05-07,0,BOS,9,3,23815,177,-6,NW
1991-05-08,0,BOS,3,8,25134,173,5,W
1991-05-09,0,BOS,4,8,26756,196,4,W
1991-05-10,0,BOS,3,5,33695,200,2,W
1991-05-11,0,BOS,4,5,33798,176,1,W
1991-05-12,0,BOS,12,5,33196,188,-7,NW
1991-05-13,0,BOS,4,3,31032,205,-1,NW
1991-05-14,0,BOS,1,4,28927,177,3,W
1991-05-15,0,BOS,6,9,31712,251,3,W
1991-05-20,0,BOS,0,3,28983,168,3,W
1991-05-21,0,BOS,6,10,28646,186,4,W
1991-05-22,0,BOS,0,4,33182,152,4,W
1991-05-30,0,BOS,9,3,33795,190,-6,NW
1991-05-31,0,BOS,2,7,33744,163,5,W
1991-06-01,0,BOS,3,1,33648,194,-2,NW
1991-06-02,0,BOS,5,1,34305,140,-4,NW
1991-06-14,0,BOS,4,9,34299,177,5,W
1991-06-15,0,BOS,3,13,32591,175,10,W
1991-06-16,0,BOS,0,2,32433,149,2,W
1991-06-17,0,BOS,4,2,32786,150,-2,NW
1991-06-18,0,BOS,2,1,33948,178,-1,NW
1991-06-19,0,BOS,4,3,33251,186,-1,NW
1991-06-20,0,BOS,7,8,33769,201,1,W
1991-06-21,0,BOS,2,3,33951,171,1,W
1991-06-22,0,BOS,5,9,34120,194,4,W
1991-06-23,0,BOS,4,2,34147,167,-2,NW
1991-06-25,0,BOS,6,4,34753,175,-2,NW
1991-06-26,0,BOS,5,1,34514,189,-4,NW
1991-06-27,0,BOS,8,0,34529,160,-8,NW
1991-07-04,0,BOS,6,1,33611,183,-5,NW
1991-07-05,0,BOS,1,10,33997,144,9,W
1991-07-06,0,BOS,4,7,34440,176,3,W
1991-07-07,0,BOS,7,6,33648,197,-1,NW
1991-07-18,0,BOS,11,3,34630,154,-8,NW
1991-07-19,0,BOS,3,2,33758,233,-1,NW
1991-07-20,0,BOS,5,0,33005,148,-5,NW
1991-07-21,0,BOS,14,1,32849,165,-13,NW
1991-07-27,1,BOS,10,8,33461,290,-2,NW
1991-07-27,2,BOS,7,4,24673,218,-3,NW
1991-07-28,0,BOS,5,2,33166,180,-3,NW
1991-07-29,0,BOS,7,2,33604,185,-5,NW
1991-07-30,0,BOS,6,11,33086,199,5,W
1991-07-31,0,BOS,10,11,34218,301,1,W
1991-08-01,0,BOS,4,2,34099,188,-2,NW
1991-08-02,0,BOS,3,5,34032,150,2,W
1991-08-03,0,BOS,1,4,34015,183,3,W
1991-08-04,0,BOS,2,1,33809,182,-1,NW
1991-08-16,0,BOS,2,3,34548,173,1,W
1991-08-17,0,BOS,4,3,34009,176,-1,NW
1991-08-18,0,BOS,1,5,34198,170,4,W
1991-08-21,1,BOS,5,13,0,164,8,W
1991-08-21,2,BOS,4,5,34069,185,1,W
1991-08-22,0,BOS,6,7,14037,193,1,W
1991-09-03,0,BOS,2,0,31179,159,-2,NW
1991-09-04,0,BOS,0,2,29600,168,2,W
1991-09-05,0,BOS,3,4,30200,185,1,W
1991-09-06,0,BOS,5,6,33002,204,1,W
1991-09-07,0,BOS,10,11,33119,246,1,W
1991-09-08,0,BOS,6,17,32979,184,11,W
1991-09-16,0,BOS,9,2,31977,189,-7,NW
1991-09-17,0,BOS,3,4,32657,167,1,W
1991-09-18,0,BOS,5,7,32021,176,2,W
1991-09-20,0,BOS,0,2,34535,149,2,W
1991-09-21,0,BOS,1,12,34520,199,11,W
1991-09-22,0,BOS,7,5,34514,232,-2,NW
1991-10-01,0,BOS,8,5,31942,203,-3,NW
1991-10-02,0,BOS,3,5,32003,200,2,W
1991-10-03,0,BOS,10,5,31162,185,-5,NW
1991-10-04,0,BOS,3,2,31894,153,-1,NW
1991-10-05,0,BOS,13,4,32185,205,-9,NW
1991-10-06,0,BOS,6,3,31837,167,-3,NW
1992-04-13,0,BOS,8,6,34472,217,-2,NW
1992-04-15,0,BOS,5,6,27185,204,1,W
1992-04-17,0,BOS,0,1,27467,194,1,W
1992-04-18,0,BOS,2,1,32640,170,-1,NW
1992-04-19,0,BOS,4,5,28196,206,1,W
1992-04-20,0,BOS,6,4,34709,252,-2,NW
1992-04-24,0,BOS,1,3,31461,115,2,W
1992-04-26,1,BOS,3,1,0,178,-2,NW
1992-04-26,2,BOS,4,2,32728,199,-2,NW
1992-04-28,0,BOS,3,6,27673,211,3,W
1992-04-29,0,BOS,1,6,27205,166,5,W
1992-05-01,0,BOS,5,6,27973,184,1,W
1992-05-02,0,BOS,6,7,31978,175,1,W
1992-05-03,0,BOS,5,2,33368,170,-3,NW
1992-05-04,0,BOS,6,1,25843,166,-5,NW
1992-05-05,0,BOS,1,4,25009,161,3,W
1992-05-15,0,BOS,0,3,33254,146,3,W
1992-05-16,0,BOS,0,3,33247,168,3,W
1992-05-17,0,BOS,3,1,32554,149,-2,NW
1992-05-18,0,BOS,2,3,24377,159,1,W
1992-05-19,0,BOS,5,7,27091,209,2,W
1992-05-20,0,BOS,4,6,32055,191,2,W
1992-05-22,0,BOS,5,3,33591,174,-2,NW
1992-05-23,0,BOS,1,5,33186,167,4,W
1992-05-24,0,BOS,4,0,33965,141,-4,NW
1992-06-06,1,BOS,1,5,0,169,4,W
1992-06-06,2,BOS,3,1,32937,144,-2,NW
1992-06-07,0,BOS,0,4,33202,174,4,W
1992-06-15,0,BOS,0,1,33577,137,1,W
1992-06-16,0,BOS,3,4,34592,220,1,W
1992-06-17,0,BOS,3,4,33916,178,1,W
1992-06-18,0,BOS,5,4,34076,209,-1,NW
1992-06-26,0,BOS,4,8,33637,160,4,W
1992-06-27,0,BOS,7,8,33734,250,1,W
1992-06-28,0,BOS,9,3,33237,192,-6,NW
1992-06-29,0,BOS,8,3,33388,204,-5,NW
1992-06-30,0,BOS,5,8,33485,185,3,W
1992-07-01,0,BOS,4,6,32059,183,2,W
1992-07-06,0,BOS,6,3,28495,162,-3,NW
1992-07-07,0,BOS,2,3,30078,232,1,W
1992-07-08,0,BOS,4,5,31196,202,1,W
1992-07-09,0,BOS,10,3,33357,174,-7,NW
1992-07-10,0,BOS,5,6,34288,176,1,W
1992-07-11,0,BOS,2,11,34288,192,9,W
1992-07-12,0,BOS,0,3,34105,158,3,W
1992-07-24,1,BOS,5,0,0,159,-5,NW
1992-07-24,2,BOS,4,5,34614,187,1,W
1992-07-25,0,BOS,3,2,34420,187,-1,NW
1992-07-26,0,BOS,8,2,33095,182,-6,NW
1992-07-27,0,BOS,5,7,32927,192,2,W
1992-07-28,0,BOS,2,1,33188,208,-1,NW
1992-07-29,0,BOS,5,6,31587,191,1,W
1992-07-31,1,BOS,4,7,28349,191,3,W
1992-07-31,2,BOS,4,3,32748,124,-1,NW
1992-08-01,0,BOS,9,3,33788,191,-6,NW
1992-08-02,0,BOS,2,1,33637,195,-1,NW
1992-08-03,0,BOS,1,7,34024,171,6,W
1992-08-04,0,BOS,4,9,33294,190,5,W
1992-08-05,0,BOS,5,4,33945,192,-1,NW
1992-08-18,0,BOS,0,8,33339,207,8,W
1992-08-19,0,BOS,3,2,32980,183,-1,NW
1992-08-20,0,BOS,2,0,32879,169,-2,NW
1992-08-21,0,BOS,5,2,33444,178,-3,NW
1992-08-22,0,BOS,8,10,33275,193,2,W
1992-08-23,0,BOS,9,3,33365,188,-6,NW
1992-08-24,0,BOS,9,3,33494,203,-6,NW
1992-08-25,0,BOS,4,5,33387,195,1,W
1992-08-26,0,BOS,1,2,33193,184,1,W
1992-09-11,0,BOS,6,7,32696,220,1,W
1992-09-12,0,BOS,9,5,32865,235,-4,NW
1992-09-13,0,BOS,7,2,32615,189,-5,NW
1992-09-14,0,BOS,6,0,27578,134,-6,NW
1992-09-15,0,BOS,7,2,23757,173,-5,NW
1992-09-16,0,BOS,1,2,24106,272,1,W
1992-09-17,0,BOS,10,4,29515,191,-6,NW
1992-09-22,0,BOS,4,2,24412,174,-2,NW
1992-09-23,0,BOS,7,3,26415,153,-4,NW
1992-09-24,0,BOS,4,6,28135,164,2,W
1992-10-02,0,BOS,6,3,33097,186,-3,NW
1992-10-03,0,BOS,5,7,33223,164,2,W
1992-10-04,0,BOS,2,8,33229,173,6,W
1993-04-13,0,BOS,2,6,29606,159,4,W
1993-04-14,0,BOS,7,12,20390,193,5,W
1993-04-15,0,BOS,3,4,22505,225,1,W
1993-04-16,0,BOS,9,4,26536,182,-5,NW
1993-04-17,0,BOS,1,5,32994,180,4,W
1993-04-18,0,BOS,0,4,34923,145,4,W
1993-04-19,0,BOS,0,6,34556,162,6,W
1993-04-30,0,BOS,1,6,31432,150,5,W
1993-05-01,0,BOS,1,3,33546,167,2,W
1993-05-02,0,BOS,3,4,31851,173,1,W
1993-05-03,0,BOS,2,0,20379,179,-2,NW
1993-05-04,0,BOS,7,6,21234,189,-1,NW
1993-05-05,0,BOS,1,3,25496,174,2,W
1993-05-06,0,BOS,6,3,28220,173,-3,NW
1993-05-17,0,BOS,9,3,30057,176,-6,NW
1993-05-19,0,BOS,5,10,27465,159,5,W
1993-05-20,0,BOS,4,3,18219,206,-1,NW
1993-05-21,0,BOS,2,7,34170,179,5,W
1993-05-22,0,BOS,7,3,34383,206,-4,NW
1993-05-23,0,BOS,2,5,33307,152,3,W
1993-05-28,0,BOS,1,4,32678,175,3,W
1993-05-29,0,BOS,1,15,32817,193,14,W
1993-05-30,0,BOS,5,6,33797,254,1,W
1993-05-31,0,BOS,5,3,21487,188,-2,NW
1993-06-01,0,BOS,4,3,23418,155,-1,NW
1993-06-02,0,BOS,7,2,29541,172,-5,NW
1993-06-10,0,BOS,2,1,33069,161,-1,NW
1993-06-11,0,BOS,16,4,33008,212,-12,NW
1993-06-12,0,BOS,5,1,33222,181,-4,NW
1993-06-13,0,BOS,2,4,33536,153,2,W
1993-06-21,0,BOS,3,6,27779,164,3,W
1993-06-22,0,BOS,1,4,29094,144,3,W
1993-06-23,0,BOS,1,3,30414,151,2,W
1993-06-25,0,BOS,2,8,33844,191,6,W
1993-06-26,0,BOS,4,13,33295,188,9,W
1993-06-27,0,BOS,2,8,32947,193,6,W
1993-06-28,0,BOS,3,4,27982,179,1,W
1993-06-29,0,BOS,7,6,30395,203,-1,NW
1993-06-30,0,BOS,2,12,28050,155,10,W
1993-07-15,0,BOS,3,2,33342,180,-1,NW
1993-07-16,0,BOS,3,5,33925,184,2,W
1993-07-17,0,BOS,3,4,33190,166,1,W
1993-07-18,0,BOS,6,7,33795,199,1,W
1993-07-19,0,BOS,6,8,30433,181,2,W
1993-07-20,0,BOS,1,2,31632,175,1,W
1993-07-21,0,BOS,1,4,34348,157,3,W
1993-07-22,0,BOS,7,9,34355,191,2,W
1993-07-23,0,BOS,5,6,34435,192,1,W
1993-07-24,0,BOS,3,5,34379,147,2,W
1993-07-25,0,BOS,1,8,34391,174,7,W
1993-08-10,0,BOS,0,5,34413,158,5,W
1993-08-11,0,BOS,8,3,34470,186,-5,NW
1993-08-12,0,BOS,4,1,34403,198,-3,NW
1993-08-13,0,BOS,3,5,34276,175,2,W
1993-08-14,0,BOS,5,2,33924,194,-3,NW
1993-08-15,0,BOS,9,1,33380,185,-8,NW
1993-08-17,0,BOS,3,2,32744,168,-1,NW
1993-08-18,0,BOS,0,5,31550,140,5,W
1993-08-19,0,BOS,5,1,32644,160,-4,NW
1993-08-20,0,BOS,7,6,31819,194,-1,NW
1993-08-21,0,BOS,10,5,32888,215,-5,NW
1993-08-22,0,BOS,3,2,33560,230,-1,NW
1993-08-30,0,BOS,3,7,32781,181,4,W
1993-08-31,0,BOS,8,1,30455,168,-7,NW
1993-09-01,0,BOS,9,7,27396,328,-2,NW
1993-09-03,0,BOS,5,1,28323,181,-4,NW
1993-09-04,0,BOS,4,2,31223,183,-2,NW
1993-09-05,0,BOS,5,2,32012,174,-3,NW
1993-09-13,0,BOS,4,6,29342,199,2,W
1993-09-14,0,BOS,11,3,26367,177,-8,NW
1993-09-15,0,BOS,5,6,27545,193,1,W
1993-09-24,0,BOS,4,7,27571,178,3,W
1993-09-25,0,BOS,9,7,33020,237,-2,NW
1993-09-26,0,BOS,5,2,29097,198,-3,NW
1993-09-28,1,BOS,6,11,0,198,5,W
1993-09-28,2,BOS,7,6,24446,271,-1,NW
1993-09-29,0,BOS,8,7,20926,194,-1,NW
1993-09-30,0,BOS,7,4,22822,169,-3,NW
1993-10-01,0,BOS,8,4,22138,166,-4,NW
1993-10-02,0,BOS,8,5,28521,184,-3,NW
1993-10-03,0,BOS,6,3,28131,261,-3,NW
1994-04-04,0,BOS,8,9,34023,213,1,W
1994-04-06,0,BOS,4,5,17977,159,1,W
1994-04-07,0,BOS,6,9,15304,205,3,W
1994-04-15,0,BOS,3,5,31085,159,2,W
1994-04-17,0,BOS,7,4,34501,175,-3,NW
1994-04-18,0,BOS,12,1,34657,186,-11,NW
1994-04-19,0,BOS,5,13,21745,180,8,W
1994-04-20,0,BOS,0,2,25372,149,2,W
1994-04-21,0,BOS,5,6,28032,200,1,W
1994-04-22,0,BOS,5,6,25870,181,1,W
1994-04-23,0,BOS,3,5,33889,175,2,W
1994-04-24,0,BOS,4,5,32521,163,1,W
1994-05-03,0,BOS,6,7,23309,215,1,W
1994-05-04,0,BOS,2,4,24807,150,2,W
1994-05-09,0,BOS,7,4,21844,194,-3,NW
1994-05-10,0,BOS,9,5,20473,206,-4,NW
1994-05-11,0,BOS,1,7,21471,158,6,W
1994-05-12,0,BOS,1,3,22126,199,2,W
1994-05-13,0,BOS,3,5,32579,180,2,W
1994-05-14,0,BOS,2,11,33771,179,9,W
1994-05-24,0,BOS,5,3,29696,184,-2,NW
1994-05-26,0,BOS,5,13,28380,204,8,W
1994-05-30,0,BOS,5,6,33341,212,1,W
1994-05-31,0,BOS,9,7,22537,173,-2,NW
1994-06-01,0,BOS,2,4,28307,197,2,W
1994-06-03,0,BOS,13,2,33524,196,-11,NW
1994-06-04,0,BOS,10,4,32325,208,-6,NW
1994-06-05,0,BOS,10,7,33803,243,-3,NW
1994-06-10,0,BOS,10,7,33673,243,-3,NW
1994-06-11,0,BOS,5,2,33295,160,-3,NW
1994-06-12,0,BOS,8,4,32280,188,-4,NW
1994-06-13,0,BOS,5,2,29159,222,-3,NW
1994-06-14,0,BOS,5,4,27874,191,-1,NW
1994-06-15,0,BOS,7,5,30243,181,-2,NW
1994-06-27,0,BOS,5,1,33204,169,-4,NW
1994-06-28,0,BOS,10,4,33268,186,-6,NW
1994-06-29,0,BOS,4,3,32704,204,-1,NW
1994-06-30,0,BOS,5,6,32967,212,1,W
1994-07-01,0,BOS,6,3,28336,169,-3,NW
1994-07-02,0,BOS,2,10,31792,162,8,W
1994-07-03,0,BOS,10,0,30943,176,-10,NW
1994-07-04,0,BOS,1,4,26624,164,3,W
1994-07-05,0,BOS,10,3,26199,182,-7,NW
1994-07-06,0,BOS,10,6,28763,226,-4,NW
1994-07-07,0,BOS,4,3,33249,161,-1,NW
1994-07-08,0,BOS,3,4,33355,171,1,W
1994-07-09,0,BOS,7,4,33092,184,-3,NW
1994-07-10,0,BOS,2,9,33555,176,7,W
1994-07-22,0,BOS,6,3,11776,220,-3,NW
1994-07-23,1,BOS,5,6,0,187,1,W
1994-07-23,2,BOS,6,3,17168,193,-3,NW
1994-07-24,0,BOS,2,8,22411,187,6,W
1994-07-29,0,BOS,2,7,33528,162,5,W
1994-07-30,0,BOS,5,1,33081,195,-4,NW
1994-07-31,0,BOS,5,2,32220,210,-3,NW
1994-08-01,1,BOS,6,2,0,178,-4,NW
1994-08-01,2,BOS,3,4,33429,172,1,W
1994-08-02,0,BOS,8,7,32976,207,-1,NW
1994-08-03,0,BOS,2,7,32047,172,5,W
1994-08-04,0,BOS,5,2,33199,200,-3,NW
1994-08-06,1,BOS,4,8,24934,199,4,W
1994-08-06,2,BOS,7,0,32405,160,-7,NW
1994-08-07,1,BOS,1,4,0,188,3,W
1994-08-07,2,BOS,15,10,34523,305,-5,NW
1995-04-26,0,BOS,0,9,32980,169,9,W
1995-04-28,0,BOS,4,10,23199,200,6,W
1995-04-29,0,BOS,0,8,27631,171,8,W
1995-04-30,0,BOS,17,11,30658,221,-6,NW
1995-05-09,0,BOS,3,4,22006,199,1,W
1995-05-10,0,BOS,2,6,19776,216,4,W
1995-05-12,0,BOS,12,2,32754,188,-10,NW
1995-05-13,0,BOS,4,6,32695,190,2,W
1995-05-14,0,BOS,2,3,32526,169,1,W
1995-05-18,0,BOS,3,4,24285,175,1,W
1995-05-19,0,BOS,9,5,23507,207,-4,NW
1995-05-20,0,BOS,7,5,29412,188,-2,NW
1995-05-21,0,BOS,12,10,32339,228,-2,NW
1995-06-02,0,BOS,5,6,33476,195,1,W
1995-06-03,0,BOS,8,10,27301,205,2,W
1995-06-04,0,BOS,1,2,28512,151,1,W
1995-06-05,0,BOS,2,3,22027,166,1,W
1995-06-06,0,BOS,12,3,23977,165,-9,NW
1995-06-07,0,BOS,1,5,23372,197,4,W
1995-06-08,0,BOS,10,8,25336,249,-2,NW
1995-06-09,0,BOS,1,4,30304,145,3,W
1995-06-10,0,BOS,8,5,31418,206,-3,NW
1995-06-11,0,BOS,8,1,29737,163,-7,NW
1995-06-16,0,BOS,4,3,29086,169,-1,NW
1995-06-17,0,BOS,9,1,29882,158,-8,NW
1995-06-18,0,BOS,2,4,28646,154,2,W
1995-06-26,0,BOS,3,4,26716,171,1,W
1995-06-27,0,BOS,5,6,30262,196,1,W
1995-06-28,0,BOS,8,4,31467,180,-4,NW
1995-06-29,0,BOS,1,7,28457,157,6,W
1995-06-30,0,BOS,7,6,31349,207,-1,NW
1995-07-01,0,BOS,11,2,33359,190,-9,NW
1995-07-02,0,BOS,11,12,34344,206,1,W
1995-07-13,0,BOS,9,8,33315,198,-1,NW
1995-07-14,0,BOS,2,5,32348,198,3,W
1995-07-15,0,BOS,7,2,34004,179,-5,NW
1995-07-16,0,BOS,5,2,30295,163,-3,NW
1995-07-17,0,BOS,4,3,24891,183,-1,NW
1995-07-18,0,BOS,1,4,26960,168,3,W
1995-07-21,0,BOS,5,13,31124,165,8,W
1995-07-22,0,BOS,8,7,34384,181,-1,NW
1995-07-23,0,BOS,8,3,34205,178,-5,NW
1995-07-24,0,BOS,1,4,26333,167,3,W
1995-07-25,0,BOS,8,3,33069,180,-5,NW
1995-07-26,0,BOS,3,5,33457,173,2,W
1995-07-27,0,BOS,5,4,34474,196,-1,NW
1995-08-08,0,BOS,1,5,34574,152,4,W
1995-08-09,0,BOS,5,9,34240,171,4,W
1995-08-10,0,BOS,1,11,33588,163,10,W
1995-08-11,0,BOS,4,5,33143,223,1,W
1995-08-12,0,BOS,0,7,34234,207,7,W
1995-08-13,0,BOS,2,3,34158,142,1,W
1995-08-14,0,BOS,3,9,34319,184,6,W
1995-08-15,0,BOS,9,2,34616,177,-7,NW
1995-08-16,0,BOS,4,7,34304,178,3,W
1995-08-29,0,BOS,6,4,31328,159,-2,NW
1995-08-30,0,BOS,6,7,32356,181,1,W
1995-08-31,0,BOS,11,2,30627,190,-9,NW
1995-09-01,0,BOS,3,11,32861,199,8,W
1995-09-02,0,BOS,4,5,32867,171,1,W
1995-09-03,0,BOS,1,8,32987,164,7,W
1995-09-05,0,BOS,4,7,27080,267,3,W
1995-09-06,0,BOS,2,8,30454,180,6,W
1995-09-18,0,BOS,6,1,28176,140,-5,NW
1995-09-19,0,BOS,3,5,27060,158,2,W
1995-09-20,0,BOS,2,3,32563,152,1,W
1995-09-23,1,BOS,0,5,32791,169,5,W
1995-09-23,2,BOS,8,6,21266,162,-2,NW
1995-09-24,0,BOS,2,1,32472,160,-1,NW
1995-09-25,0,BOS,7,4,25661,166,-3,NW
1995-09-26,0,BOS,1,5,24032,129,4,W
1995-09-27,0,BOS,7,5,30989,159,-2,NW
1996-04-09,0,BOS,1,9,30843,160,8,W
1996-04-11,0,BOS,6,5,15594,200,-1,NW
1996-04-12,0,BOS,3,1,26703,187,-2,NW
1996-04-13,0,BOS,14,2,31827,192,-12,NW
1996-04-14,0,BOS,7,6,31796,282,-1,NW
1996-04-15,0,BOS,8,0,32861,152,-8,NW
1996-04-24,0,BOS,9,11,19217,213,2,W
1996-04-25,0,BOS,3,8,20350,176,5,W
1996-04-26,0,BOS,4,3,22385,176,-1,NW
1996-04-27,0,BOS,10,0,29459,163,-10,NW
1996-04-28,0,BOS,9,7,32491,197,-2,NW
1996-04-30,0,BOS,4,13,18504,167,9,W
1996-05-01,0,BOS,1,5,20828,143,4,W
1996-05-03,0,BOS,7,8,25570,200,1,W
1996-05-04,0,BOS,4,8,29785,210,4,W
1996-05-05,0,BOS,11,4,29866,174,-7,NW
1996-05-14,0,BOS,3,4,22450,242,1,W
1996-05-15,0,BOS,6,17,23455,197,11,W
1996-05-17,0,BOS,3,5,28690,205,2,W
1996-05-18,0,BOS,6,5,31663,206,-1,NW
1996-05-19,0,BOS,2,12,32601,187,10,W
1996-05-20,0,BOS,4,16,20890,187,12,W
1996-05-21,0,BOS,13,7,24528,195,-6,NW
1996-05-22,0,BOS,6,1,26753,157,-5,NW
1996-05-23,0,BOS,4,11,31551,190,7,W
1996-06-04,0,BOS,6,4,23715,225,-2,NW
1996-06-05,0,BOS,8,6,24246,264,-2,NW
1996-06-06,0,BOS,4,7,24382,189,3,W
1996-06-07,0,BOS,7,10,26861,189,3,W
1996-06-08,0,BOS,3,2,30399,222,-1,NW
1996-06-09,0,BOS,11,8,28120,235,-3,NW
1996-06-13,0,BOS,7,8,32645,266,1,W
1996-06-14,0,BOS,3,4,29689,176,1,W
1996-06-15,0,BOS,13,3,33186,202,-10,NW
1996-06-16,0,BOS,9,10,30461,191,1,W
1996-06-25,0,BOS,4,0,33576,175,-4,NW
1996-06-26,0,BOS,4,6,33727,314,2,W
1996-06-27,0,BOS,9,6,29582,189,-3,NW
1996-06-28,0,BOS,5,8,27578,195,3,W
1996-06-29,0,BOS,6,13,33509,188,7,W
1996-06-30,0,BOS,4,9,31217,164,5,W
1996-07-15,0,BOS,6,8,33263,186,2,W
1996-07-16,0,BOS,9,5,34676,211,-4,NW
1996-07-17,0,BOS,11,12,34082,238,1,W
1996-07-18,0,BOS,6,3,33014,206,-3,NW
1996-07-19,0,BOS,2,13,32262,173,11,W
1996-07-20,0,BOS,0,2,33590,159,2,W
1996-07-21,0,BOS,10,6,34423,249,-4,NW
1996-07-22,0,BOS,5,2,28109,142,-3,NW
1996-07-23,0,BOS,7,5,23711,193,-2,NW
1996-07-24,0,BOS,2,12,33381,189,10,W
1996-08-02,0,BOS,10,11,28041,200,1,W
1996-08-03,1,BOS,3,6,19860,150,3,W
1996-08-03,2,BOS,6,0,29135,152,-6,NW
1996-08-04,0,BOS,6,13,29939,169,7,W
1996-08-05,0,BOS,1,3,23884,142,2,W
1996-08-06,0,BOS,2,3,25264,146,1,W
1996-08-07,0,BOS,0,8,30443,120,8,W
1996-08-08,0,BOS,9,6,32696,183,-3,NW
1996-08-16,0,BOS,6,3,30693,151,-3,NW
1996-08-17,0,BOS,0,6,32497,162,6,W
1996-08-18,0,BOS,4,3,25224,196,-1,NW
1996-08-19,0,BOS,9,10,25779,238,1,W
1996-08-20,0,BOS,3,4,25094,159,1,W
1996-08-21,0,BOS,4,6,26362,185,2,W
1996-08-22,0,BOS,1,2,30503,161,1,W
1996-08-23,0,BOS,6,4,33079,193,-2,NW
1996-08-24,0,BOS,5,9,32928,200,4,W
1996-08-25,0,BOS,5,8,34377,170,3,W
1996-09-09,0,BOS,6,0,22386,167,-6,NW
1996-09-10,0,BOS,11,10,20487,204,-1,NW
1996-09-11,0,BOS,1,4,21310,144,3,W
1996-09-13,0,BOS,5,9,28907,210,4,W
1996-09-14,0,BOS,13,5,31841,208,-8,NW
1996-09-15,0,BOS,8,9,32452,179,1,W
1996-09-24,0,BOS,8,13,28557,219,5,W
1996-09-25,0,BOS,6,2,28432,147,-4,NW
1996-09-26,0,BOS,3,5,32367,157,2,W
1996-09-27,0,BOS,5,7,32573,173,2,W
1996-09-28,0,BOS,4,2,33612,179,-2,NW
1996-09-29,0,BOS,5,6,32563,174,1,W
1997-04-11,0,BOS,5,3,34210,183,-2,NW
1997-04-12,0,BOS,5,1,15358,186,-4,NW
1997-04-13,0,BOS,1,7,30300,157,6,W
1997-04-14,0,BOS,1,10,18166,136,9,W
1997-04-15,0,BOS,2,7,17862,179,5,W
1997-04-16,0,BOS,6,11,21305,183,5,W
1997-04-17,0,BOS,4,3,17988,216,-1,NW
1997-04-20,0,BOS,11,1,32290,193,-10,NW
1997-04-21,0,BOS,2,4,33608,180,2,W
1997-04-29,0,BOS,5,4,19347,229,-1,NW
1997-04-30,0,BOS,2,11,20322,156,9,W
1997-05-05,0,BOS,2,0,19061,158,-2,NW
1997-05-06,0,BOS,7,2,20178,171,-5,NW
1997-05-07,0,BOS,3,11,19075,185,8,W
1997-05-08,0,BOS,10,7,24595,206,-3,NW
1997-05-09,0,BOS,5,1,23514,164,-4,NW
1997-05-10,0,BOS,11,5,25084,193,-6,NW
1997-05-11,0,BOS,8,6,27025,218,-2,NW
1997-05-26,0,BOS,2,3,28438,149,1,W
1997-05-27,0,BOS,6,7,24396,195,1,W
1997-05-28,0,BOS,3,5,28078,169,2,W
1997-05-29,0,BOS,5,2,27775,223,-3,NW
1997-05-30,0,BOS,4,10,32341,164,6,W
1997-05-31,0,BOS,7,2,32736,175,-5,NW
1997-06-01,0,BOS,11,6,31798,328,-5,NW
1997-06-02,0,BOS,5,2,31329,207,-3,NW
1997-06-06,0,BOS,7,3,30202,181,-4,NW
1997-06-07,0,BOS,9,5,32780,188,-4,NW
1997-06-08,0,BOS,6,12,32155,211,6,W
1997-06-10,1,BOS,7,2,0,169,-5,NW
1997-06-10,2,BOS,4,2,30995,176,-2,NW
1997-06-11,0,BOS,1,10,26479,175,9,W
1997-06-12,0,BOS,5,9,24970,161,4,W
1997-06-16,0,BOS,4,5,26926,214,1,W
1997-06-17,0,BOS,6,12,25591,217,6,W
1997-06-18,0,BOS,2,4,27502,154,2,W
1997-06-26,0,BOS,10,6,31878,212,-4,NW
1997-06-27,0,BOS,2,1,26753,185,-1,NW
1997-06-28,0,BOS,9,2,30886,188,-7,NW
1997-06-29,0,BOS,6,8,30844,190,2,W
1997-06-30,0,BOS,8,5,27127,167,-3,NW
1997-07-01,0,BOS,2,9,25538,186,7,W
1997-07-02,0,BOS,3,2,31405,174,-1,NW
1997-07-10,0,BOS,7,8,30913,256,1,W
1997-07-11,0,BOS,8,4,32543,162,-4,NW
1997-07-12,0,BOS,3,1,33106,182,-2,NW
1997-07-13,0,BOS,3,2,32418,146,-1,NW
1997-07-14,0,BOS,4,18,21997,193,14,W
1997-07-15,0,BOS,7,5,25822,247,-2,NW
1997-07-22,0,BOS,3,4,27864,190,1,W
1997-07-23,0,BOS,5,2,29213,163,-3,NW
1997-07-24,0,BOS,0,3,29312,142,3,W
1997-07-25,1,BOS,5,4,20427,195,-1,NW
1997-07-25,2,BOS,8,5,24631,215,-3,NW
1997-07-26,0,BOS,6,7,32148,202,1,W
1997-07-27,0,BOS,5,6,28454,174,1,W
1997-07-29,0,BOS,0,4,33293,139,4,W
1997-07-30,0,BOS,7,8,33056,226,1,W
1997-08-08,0,BOS,2,8,31777,163,6,W
1997-08-09,0,BOS,9,2,31410,149,-7,NW
1997-08-10,0,BOS,4,6,27743,203,2,W
1997-08-11,0,BOS,8,3,28640,163,-5,NW
1997-08-12,0,BOS,12,2,26213,170,-10,NW
1997-08-13,0,BOS,7,6,24522,187,-1,NW
1997-08-14,0,BOS,1,6,31207,149,5,W
1997-08-15,0,BOS,4,5,25328,186,1,W
1997-08-16,0,BOS,4,12,30011,193,8,W
1997-08-17,0,BOS,5,10,30387,167,5,W
1997-08-29,0,BOS,9,1,32577,179,-8,NW
1997-08-30,0,BOS,15,2,32865,162,-13,NW
1997-08-31,0,BOS,7,3,33147,174,-4,NW
1997-09-05,0,BOS,7,1,27522,155,-6,NW
1997-09-06,0,BOS,2,10,28686,154,8,W
1997-09-07,0,BOS,2,11,27731,168,9,W
1997-09-09,0,BOS,8,6,32355,191,-2,NW
1997-09-10,0,BOS,2,5,31011,184,3,W
1997-09-17,0,BOS,3,4,23648,157,1,W
1997-09-18,0,BOS,2,3,27990,172,1,W
1997-09-19,0,BOS,5,4,27647,184,-1,NW
1997-09-20,0,BOS,6,4,30549,190,-2,NW
1997-09-21,0,BOS,2,5,27229,153,3,W
1998-04-10,0,BOS,7,9,32805,201,2,W
1998-04-11,0,BOS,0,5,32403,149,5,W
1998-04-12,0,BOS,7,8,23270,211,1,W
1998-04-13,0,BOS,3,6,18011,166,3,W
1998-04-14,0,BOS,6,8,18490,208,2,W
1998-04-15,0,BOS,3,4,18477,172,1,W
1998-04-17,0,BOS,2,3,26924,160,1,W
1998-04-18,0,BOS,7,4,31735,175,-3,NW
1998-04-19,0,BOS,0,2,31846,159,2,W
1998-04-20,0,BOS,5,6,33001,233,1,W
1998-04-27,0,BOS,5,6,18456,170,1,W
1998-04-28,0,BOS,7,5,20936,176,-2,NW
1998-04-29,0,BOS,4,8,21557,175,4,W
1998-04-30,0,BOS,7,2,21526,157,-5,NW
1998-05-01,0,BOS,3,5,24169,157,2,W
1998-05-02,0,BOS,7,6,25827,173,-1,NW
1998-05-03,0,BOS,1,2,28075,153,1,W
1998-05-05,0,BOS,2,4,20882,133,2,W
1998-05-06,0,BOS,8,7,20954,192,-1,NW
1998-05-15,0,BOS,2,5,31466,133,3,W
1998-05-16,0,BOS,0,5,31700,142,5,W
1998-05-17,0,BOS,3,5,29736,161,2,W
1998-05-19,0,BOS,9,5,27121,180,-4,NW
1998-05-20,0,BOS,2,6,26953,153,4,W
1998-05-22,0,BOS,4,5,33605,150,1,W
1998-05-23,0,BOS,12,3,33120,196,-9,NW
1998-05-24,0,BOS,14,4,33042,201,-10,NW
1998-05-25,0,BOS,7,5,32342,179,-2,NW
1998-05-26,0,BOS,5,2,27668,164,-3,NW
1998-06-03,0,BOS,3,0,31355,160,-3,NW
1998-06-04,0,BOS,1,9,33104,171,8,W
1998-06-05,0,BOS,9,2,32214,157,-7,NW
1998-06-06,0,BOS,1,0,32545,150,-1,NW
1998-06-07,0,BOS,0,5,30630,135,5,W
1998-06-12,0,BOS,1,5,31994,162,4,W
1998-06-14,0,BOS,2,3,27768,214,1,W
1998-06-22,0,BOS,9,8,33592,192,-1,NW
1998-06-23,0,BOS,3,2,33212,158,-1,NW
1998-06-30,0,BOS,4,7,27704,170,3,W
1998-07-01,0,BOS,1,6,24923,156,5,W
1998-07-02,0,BOS,0,15,32637,157,15,W
1998-07-03,0,BOS,2,15,32467,153,13,W
1998-07-04,0,BOS,3,0,29600,155,-3,NW
1998-07-05,0,BOS,14,15,32970,225,1,W
1998-07-15,0,BOS,0,1,33501,137,1,W
1998-07-16,0,BOS,5,15,33568,168,10,W
1998-07-23,0,BOS,7,8,33011,212,1,W
1998-07-24,0,BOS,10,6,33159,192,-4,NW
1998-07-25,0,BOS,3,5,33099,144,2,W
1998-07-26,0,BOS,3,6,33059,179,3,W
1998-08-11,0,BOS,4,7,33290,198,3,W
1998-08-12,0,BOS,8,4,32488,224,-4,NW
1998-08-13,0,BOS,7,8,32801,206,1,W
1998-08-14,0,BOS,12,13,32888,208,1,W
1998-08-15,0,BOS,3,2,32412,187,-1,NW
1998-08-16,0,BOS,6,3,30893,185,-3,NW
1998-08-18,1,BOS,1,4,33201,154,3,W
1998-08-18,2,BOS,4,5,26677,193,1,W
1998-08-25,0,BOS,2,3,28366,176,1,W
1998-08-26,0,BOS,4,7,26379,188,3,W
1998-08-27,0,BOS,6,3,31239,186,-3,NW
1998-08-28,0,BOS,7,6,32470,205,-1,NW
1998-08-29,0,BOS,1,6,32519,127,5,W
1998-08-30,0,BOS,8,6,31476,186,-2,NW
1998-08-31,0,BOS,1,5,28553,152,4,W
1998-09-01,0,BOS,7,3,28150,187,-4,NW
1998-09-02,0,BOS,3,7,25813,193,4,W
1998-09-07,0,BOS,3,4,32106,166,1,W
1998-09-08,0,BOS,3,2,33409,199,-1,NW
1998-09-09,0,BOS,7,5,32942,165,-2,NW
1998-09-11,0,BOS,2,6,29131,184,4,W
1998-09-12,0,BOS,3,2,31220,159,-1,NW
1998-09-13,0,BOS,4,1,31255,164,-3,NW
1998-09-21,1,BOS,3,4,0,180,1,W
1998-09-21,2,BOS,8,4,23379,184,-4,NW
1998-09-22,0,BOS,2,11,20399,156,9,W
1998-09-23,0,BOS,4,5,23240,172,1,W
1998-09-24,0,BOS,6,9,30997,188,3,W
1998-09-25,0,BOS,3,8,32644,172,5,W
1998-09-26,0,BOS,5,2,29226,159,-3,NW
1998-09-27,0,BOS,4,6,32158,197,2,W
1999-04-13,0,BOS,0,6,31874,154,6,W
1999-04-15,0,BOS,4,0,22461,172,-4,NW
1999-04-16,0,BOS,6,2,18809,185,-4,NW
1999-04-17,0,BOS,5,8,26799,173,3,W
1999-04-18,0,BOS,5,1,27589,173,-4,NW
1999-04-19,0,BOS,4,1,33167,149,-3,NW
1999-04-23,0,BOS,7,6,29921,197,-1,NW
1999-04-24,0,BOS,4,9,29481,214,5,W
1999-04-25,0,BOS,2,3,30472,188,1,W
1999-05-05,0,BOS,8,3,20960,169,-5,NW
1999-05-06,0,BOS,2,3,21412,179,1,W
1999-05-07,0,BOS,0,6,32220,158,6,W
1999-05-08,0,BOS,1,6,29385,139,5,W
1999-05-09,0,BOS,2,4,23710,160,2,W
1999-05-10,0,BOS,4,12,21660,174,8,W
1999-05-11,0,BOS,8,5,24416,211,-3,NW
1999-05-12,0,BOS,2,9,28177,165,7,W
1999-05-18,0,BOS,3,6,33620,210,3,W
1999-05-19,0,BOS,0,6,32091,147,6,W
1999-05-20,0,BOS,3,1,33139,179,-2,NW
1999-05-21,0,BOS,2,5,27284,165,3,W
1999-05-22,0,BOS,4,6,32038,166,2,W
1999-05-23,0,BOS,8,10,28559,198,2,W
1999-05-31,0,BOS,7,8,27883,177,1,W
1999-06-01,0,BOS,4,5,26456,153,1,W
1999-06-02,0,BOS,4,2,27280,151,-2,NW
1999-06-04,0,BOS,1,5,33411,134,4,W
1999-06-05,0,BOS,6,5,32793,164,-1,NW
1999-06-06,0,BOS,3,2,32184,189,-1,NW
1999-06-14,0,BOS,3,4,30099,176,1,W
1999-06-15,0,BOS,2,4,31805,150,2,W
1999-06-16,0,BOS,1,5,30085,169,4,W
1999-06-17,0,BOS,8,7,31446,200,-1,NW
1999-06-18,0,BOS,4,1,31427,145,-3,NW
1999-06-19,0,BOS,4,7,31950,173,3,W
1999-06-20,0,BOS,2,5,31501,175,3,W
1999-06-21,0,BOS,4,5,27627,155,1,W
1999-06-25,0,BOS,1,6,31097,151,5,W
1999-06-26,0,BOS,1,17,32758,155,16,W
1999-06-27,0,BOS,7,6,30627,171,-1,NW
1999-06-28,0,BOS,1,14,24616,170,13,W
1999-06-30,0,BOS,11,10,27961,231,-1,NW
1999-07-01,0,BOS,12,3,29270,194,-9,NW
1999-07-15,0,BOS,4,6,32397,170,2,W
1999-07-16,0,BOS,5,4,32899,201,-1,NW
1999-07-17,0,BOS,11,3,32228,191,-8,NW
1999-07-18,0,BOS,9,11,30288,177,2,W
1999-07-19,0,BOS,10,7,23282,205,-3,NW
1999-07-20,0,BOS,1,7,25346,170,6,W
1999-07-21,0,BOS,6,1,33690,152,-5,NW
1999-07-22,0,BOS,5,2,33605,153,-3,NW
1999-07-30,0,BOS,13,3,33777,183,-10,NW
1999-07-31,0,BOS,5,6,33179,199,1,W
1999-08-01,0,BOS,4,5,33553,179,1,W
1999-08-02,0,BOS,7,5,33218,196,-2,NW
1999-08-03,0,BOS,5,4,33650,205,-1,NW
1999-08-04,0,BOS,2,7,33282,186,5,W
1999-08-13,0,BOS,6,11,33653,227,5,W
1999-08-14,0,BOS,2,13,33253,198,11,W
1999-08-15,0,BOS,4,3,32460,162,-1,NW
1999-08-16,0,BOS,5,6,30957,193,1,W
1999-08-17,0,BOS,12,1,31246,186,-11,NW
1999-08-18,0,BOS,4,7,32405,168,3,W
1999-08-19,0,BOS,6,2,33393,171,-4,NW
1999-08-27,0,BOS,3,4,32921,146,1,W
1999-08-28,0,BOS,6,7,33060,162,1,W
1999-08-29,0,BOS,4,7,32253,186,3,W
1999-08-30,0,BOS,1,9,32705,193,8,W
1999-08-31,0,BOS,3,6,32177,179,3,W
1999-09-01,0,BOS,3,4,31743,160,1,W
1999-09-02,0,BOS,4,2,31387,167,-2,NW
1999-09-17,0,BOS,3,14,29038,183,11,W
1999-09-18,0,BOS,1,9,32382,167,8,W
1999-09-19,0,BOS,3,7,30777,142,4,W
1999-09-21,0,BOS,0,3,27799,147,3,W
1999-09-22,0,BOS,14,9,25345,212,-5,NW
1999-09-23,0,BOS,7,5,30780,177,-2,NW
1999-09-24,0,BOS,1,0,32930,157,-1,NW
1999-09-25,0,BOS,1,4,32107,155,3,W
1999-09-26,0,BOS,8,5,32115,173,-3,NW
1999-09-27,0,BOS,3,5,33477,157,2,W
2000-04-11,0,BOS,4,13,33114,180,9,W
2000-04-12,0,BOS,3,7,20313,168,4,W
2000-04-13,0,BOS,3,4,22194,174,1,W
2000-04-14,0,BOS,13,6,29472,205,-7,NW
2000-04-15,0,BOS,2,14,33122,186,12,W
2000-04-16,0,BOS,4,5,32385,174,1,W
2000-04-17,0,BOS,1,0,33240,178,-1,NW
2000-05-01,0,BOS,6,10,24087,166,4,W
2000-05-02,0,BOS,7,6,22897,236,-1,NW
2000-05-03,0,BOS,2,4,27397,147,2,W
2000-05-05,0,BOS,3,5,32479,174,2,W
2000-05-06,0,BOS,1,0,32497,156,-1,NW
2000-05-07,0,BOS,7,9,32336,189,2,W
2000-05-08,0,BOS,2,3,23468,151,1,W
2000-05-09,0,BOS,6,0,25371,142,-6,NW
2000-05-10,0,BOS,3,5,28911,136,2,W
2000-05-19,0,BOS,0,3,31973,158,3,W
2000-05-20,0,BOS,2,1,31909,192,-1,NW
2000-05-21,0,BOS,7,5,31893,214,-2,NW
2000-05-23,0,BOS,3,2,33402,175,-1,NW
2000-05-24,0,BOS,3,6,31250,219,3,W
2000-05-25,0,BOS,11,6,32716,186,-5,NW
2000-05-30,0,BOS,2,8,31861,173,6,W
2000-05-31,0,BOS,9,7,32503,215,-2,NW
2000-06-01,0,BOS,13,11,32661,212,-2,NW
2000-06-08,0,BOS,0,3,31438,150,3,W
2000-06-16,0,BOS,4,7,33638,189,3,W
2000-06-17,0,BOS,11,10,32951,192,-1,NW
2000-06-18,0,BOS,5,1,32925,179,-4,NW
2000-06-19,0,BOS,22,1,33370,182,-21,NW
2000-06-20,0,BOS,3,0,33909,160,-3,NW
2000-06-21,0,BOS,7,9,32958,205,2,W
2000-06-22,0,BOS,2,4,33744,182,2,W
2000-06-27,0,BOS,6,3,32813,223,-3,NW
2000-06-28,0,BOS,8,7,33834,260,-1,NW
2000-06-29,0,BOS,4,12,33612,180,8,W
2000-07-07,0,BOS,5,3,33686,194,-2,NW
2000-07-08,0,BOS,5,1,33311,176,-4,NW
2000-07-09,0,BOS,2,7,33018,149,5,W
2000-07-13,0,BOS,3,4,33894,190,1,W
2000-07-14,0,BOS,6,4,33293,201,-2,NW
2000-07-15,0,BOS,4,6,33213,180,2,W
2000-07-16,0,BOS,2,5,32164,156,3,W
2000-07-17,0,BOS,3,7,32703,196,4,W
2000-07-18,0,BOS,1,3,32629,159,2,W
2000-07-21,0,BOS,8,5,33869,196,-3,NW
2000-07-22,0,BOS,6,8,33384,179,2,W
2000-07-23,0,BOS,0,1,33224,148,1,W
2000-07-24,0,BOS,4,2,33469,178,-2,NW
2000-07-25,0,BOS,4,2,33668,182,-2,NW
2000-08-04,0,BOS,4,5,33702,186,1,W
2000-08-05,0,BOS,7,5,31441,189,-2,NW
2000-08-06,0,BOS,3,1,33442,163,-2,NW
2000-08-14,0,BOS,3,7,32174,187,4,W
2000-08-15,0,BOS,3,1,33015,211,-2,NW
2000-08-16,0,BOS,3,4,31467,192,1,W
2000-08-17,0,BOS,7,8,33510,198,1,W
2000-08-18,0,BOS,4,6,33009,172,2,W
2000-08-19,0,BOS,0,9,33222,166,9,W
2000-08-20,0,BOS,6,2,32467,171,-4,NW
2000-08-21,0,BOS,6,7,32795,206,1,W
2000-08-22,0,BOS,11,4,33163,166,-7,NW
2000-08-23,0,BOS,1,3,32958,177,2,W
2000-09-01,0,BOS,2,6,33021,169,4,W
2000-09-02,0,BOS,4,1,31830,193,-3,NW
2000-09-03,0,BOS,5,0,32668,171,-5,NW
2000-09-04,0,BOS,1,5,32619,156,4,W
2000-09-05,0,BOS,3,10,31825,179,7,W
2000-09-06,0,BOS,6,4,31262,206,-2,NW
2000-09-07,0,BOS,6,11,32283,186,5,W
2000-09-08,0,BOS,4,0,33861,195,-4,NW
2000-09-09,0,BOS,5,3,33355,188,-2,NW
2000-09-10,0,BOS,6,2,33062,189,-4,NW
2000-09-19,0,BOS,4,7,32512,206,3,W
2000-09-20,1,BOS,2,1,33002,164,-1,NW
2000-09-20,2,BOS,5,4,32751,234,-1,NW
2000-09-21,1,BOS,8,9,31404,244,1,W
2000-09-21,2,BOS,8,5,32743,209,-3,NW
2000-09-22,0,BOS,3,1,32708,137,-2,NW
2000-09-23,0,BOS,7,8,32273,214,1,W
2000-09-24,0,BOS,1,0,32183,172,-1,NW
2001-04-06,0,BOS,4,11,33525,186,7,W
2001-04-07,0,BOS,2,6,31660,155,4,W
2001-04-08,0,BOS,0,3,31383,152,3,W
2001-04-10,0,BOS,1,10,27664,176,9,W
2001-04-11,0,BOS,5,4,26302,207,-1,NW
2001-04-12,0,BOS,2,8,30083,177,6,W
2001-04-13,0,BOS,2,3,33124,196,1,W
2001-04-14,0,BOS,3,2,33396,188,-1,NW
2001-04-15,0,BOS,4,5,32127,197,1,W
2001-04-16,0,BOS,1,4,33373,158,3,W
2001-04-24,0,BOS,4,9,32557,169,5,W
2001-04-25,0,BOS,6,4,33177,205,-2,NW
2001-04-26,0,BOS,0,2,32222,167,2,W
2001-04-27,0,BOS,2,9,31850,160,7,W
2001-04-28,0,BOS,8,2,32442,181,-6,NW
2001-04-29,0,BOS,11,8,32791,251,-3,NW
2001-05-08,0,BOS,4,12,32941,181,8,W
2001-05-09,0,BOS,10,5,31616,215,-5,NW
2001-05-10,0,BOS,5,2,31428,180,-3,NW
2001-05-11,0,BOS,7,6,32718,216,-1,NW
2001-05-12,0,BOS,3,9,32686,171,6,W
2001-05-13,0,BOS,4,5,31926,233,1,W
2001-05-25,0,BOS,0,4,32912,166,4,W
2001-05-26,0,BOS,5,0,31035,172,-5,NW
2001-05-27,0,BOS,2,4,31420,158,2,W
2001-05-28,0,BOS,4,3,33125,209,-1,NW
2001-05-30,0,BOS,0,3,33711,165,3,W
2001-06-05,0,BOS,3,4,32814,352,1,W
2001-06-06,0,BOS,7,3,32794,194,-4,NW
2001-06-07,0,BOS,1,8,32132,179,7,W
2001-06-08,0,BOS,2,3,33435,159,1,W
2001-06-09,0,BOS,5,2,32944,153,-3,NW
2001-06-10,0,BOS,4,5,32767,191,1,W
2001-06-12,0,BOS,2,4,32816,162,2,W
2001-06-13,0,BOS,4,2,32637,171,-2,NW
2001-06-14,0,BOS,4,6,33225,161,2,W
2001-06-22,0,BOS,4,3,33844,161,-1,NW
2001-06-23,0,BOS,9,6,33266,205,-3,NW
2001-06-24,0,BOS,5,2,32804,174,-3,NW
2001-06-25,0,BOS,8,12,32854,204,4,W
2001-06-26,0,BOS,6,7,32185,175,1,W
2001-06-27,0,BOS,9,7,33216,216,-2,NW
2001-06-28,0,BOS,4,3,33433,176,-1,NW
2001-07-06,0,BOS,6,5,33723,218,-1,NW
2001-07-07,0,BOS,1,3,33355,157,2,W
2001-07-08,0,BOS,8,0,32677,155,-8,NW
2001-07-24,0,BOS,4,6,33154,158,2,W
2001-07-25,0,BOS,4,3,33030,196,-1,NW
2001-07-26,0,BOS,3,6,33094,199,3,W
2001-07-27,0,BOS,5,9,33813,162,4,W
2001-07-28,0,BOS,3,1,33316,173,-2,NW
2001-07-29,0,BOS,3,4,33375,182,1,W
2001-07-31,0,BOS,4,3,33909,165,-1,NW
2001-08-01,0,BOS,4,2,33551,162,-2,NW
2001-08-02,0,BOS,13,4,33611,185,-9,NW
2001-08-04,1,BOS,4,10,32249,202,6,W
2001-08-04,2,BOS,2,6,32338,141,4,W
2001-08-05,0,BOS,3,6,32923,166,3,W
2001-08-06,0,BOS,7,10,33977,196,3,W
2001-08-14,0,BOS,6,3,33790,233,-3,NW
2001-08-15,0,BOS,6,2,33186,164,-4,NW
2001-08-16,0,BOS,4,6,33548,163,2,W
2001-08-17,0,BOS,11,5,33680,185,-6,NW
2001-08-18,0,BOS,1,5,31199,183,4,W
2001-08-19,0,BOS,13,7,33145,245,-6,NW
2001-08-31,0,BOS,3,1,33501,178,-2,NW
2001-09-01,0,BOS,2,1,33084,171,-1,NW
2001-09-02,0,BOS,1,0,33734,180,-1,NW
2001-09-04,0,BOS,8,5,32145,215,-3,NW
2001-09-05,0,BOS,7,10,32029,192,3,W
2001-09-06,0,BOS,6,4,32500,188,-2,NW
2001-09-18,0,BOS,2,7,30909,160,5,W
2001-09-19,0,BOS,12,2,29627,194,-10,NW
2001-09-20,0,BOS,1,2,29530,170,1,W
2001-09-21,0,BOS,2,5,30905,153,3,W
2001-09-22,0,BOS,4,3,30871,185,-1,NW
2001-09-23,0,BOS,12,6,31333,184,-6,NW
2001-09-24,0,BOS,5,1,30114,171,-4,NW
2001-09-25,0,BOS,12,7,29726,209,-5,NW
2001-09-26,0,BOS,6,9,31603,170,3,W
2001-09-27,0,BOS,4,2,32719,167,-2,NW
2002-04-01,0,BOS,12,11,33520,252,-1,NW
2002-04-09,0,BOS,4,8,31115,152,4,W
2002-04-10,0,BOS,6,2,33376,162,-4,NW
2002-04-11,0,BOS,8,5,32953,210,-3,NW
2002-04-12,0,BOS,2,3,32812,186,1,W
2002-04-13,0,BOS,6,7,33756,189,1,W
2002-04-14,0,BOS,6,2,33742,172,-4,NW
2002-04-15,0,BOS,3,4,33864,186,1,W
2002-04-26,0,BOS,2,4,32292,146,2,W
2002-04-27,0,BOS,0,10,32837,148,10,W
2002-04-29,0,BOS,5,3,31177,178,-2,NW
2002-04-30,0,BOS,0,4,31751,140,4,W
2002-05-01,0,BOS,3,15,33274,161,12,W
2002-05-14,0,BOS,2,6,31404,169,4,W
2002-05-15,0,BOS,2,8,32346,173,6,W
2002-05-16,0,BOS,5,0,33057,171,-5,NW
2002-05-17,0,BOS,6,3,33205,179,-3,NW
2002-05-18,0,BOS,1,4,32385,145,3,W
2002-05-19,0,BOS,2,3,32783,164,1,W
2002-05-20,0,BOS,0,9,32461,140,9,W
2002-05-21,0,BOS,8,3,31772,168,-5,NW
2002-05-22,0,BOS,2,0,33157,142,-2,NW
2002-05-23,0,BOS,1,3,33884,156,2,W
2002-05-24,0,BOS,8,9,34175,255,1,W
2002-05-25,0,BOS,3,2,33743,198,-1,NW
2002-05-26,0,BOS,14,5,34096,206,-9,NW
2002-06-07,0,BOS,7,5,32853,182,-2,NW
2002-06-08,0,BOS,3,2,33275,172,-1,NW
2002-06-09,0,BOS,7,3,32209,172,-4,NW
2002-06-10,0,BOS,3,7,33508,171,4,W
2002-06-11,0,BOS,3,1,32340,150,-2,NW
2002-06-12,0,BOS,5,7,31583,211,2,W
2002-06-25,0,BOS,4,2,34064,193,-2,NW
2002-06-26,0,BOS,4,7,32255,164,3,W
2002-06-28,0,BOS,4,2,33137,190,-2,NW
2002-06-29,0,BOS,2,1,32651,178,-1,NW
2002-06-30,0,BOS,7,3,32348,227,-4,NW
2002-07-01,0,BOS,0,4,33005,142,4,W
2002-07-02,1,BOS,1,2,32993,154,1,W
2002-07-02,2,BOS,4,6,32902,194,2,W
2002-07-03,0,BOS,2,5,31777,184,3,W
2002-07-04,0,BOS,5,9,32086,162,4,W
2002-07-05,0,BOS,9,5,33571,166,-4,NW
2002-07-06,0,BOS,0,8,32458,150,8,W
2002-07-07,0,BOS,9,8,33297,209,-1,NW
2002-07-23,1,BOS,4,22,33190,160,18,W
2002-07-23,2,BOS,5,4,32729,155,-1,NW
2002-07-24,0,BOS,9,5,32969,188,-4,NW
2002-07-25,0,BOS,0,6,33439,130,6,W
2002-07-26,0,BOS,9,2,33840,172,-7,NW
2002-07-27,0,BOS,0,4,33474,142,4,W
2002-07-28,0,BOS,3,12,33371,172,9,W
2002-08-06,0,BOS,9,1,34059,188,-8,NW
2002-08-07,0,BOS,3,2,33325,205,-1,NW
2002-08-08,0,BOS,2,4,33855,152,2,W
2002-08-09,0,BOS,5,4,33973,179,-1,NW
2002-08-10,0,BOS,0,2,32018,142,2,W
2002-08-11,0,BOS,1,3,33470,148,2,W
2002-08-20,0,BOS,3,2,33742,221,-1,NW
2002-08-21,0,BOS,3,5,32726,204,2,W
2002-08-22,0,BOS,3,12,33014,175,9,W
2002-08-23,0,BOS,1,4,33221,160,3,W
2002-08-24,0,BOS,2,0,32510,180,-2,NW
2002-08-25,0,BOS,8,3,32059,183,-5,NW
2002-08-26,0,BOS,9,10,32869,241,1,W
2002-08-27,0,BOS,6,0,33810,203,-6,NW
2002-08-28,0,BOS,7,0,33793,176,-7,NW
2002-09-05,0,BOS,5,4,30021,184,-1,NW
2002-09-06,0,BOS,2,7,31847,153,5,W
2002-09-07,0,BOS,1,4,31591,168,3,W
2002-09-08,0,BOS,9,4,31344,172,-5,NW
2002-09-13,0,BOS,8,3,32166,192,-5,NW
2002-09-14,0,BOS,4,6,32123,161,2,W
2002-09-15,0,BOS,8,3,31007,184,-5,NW
2002-09-16,1,BOS,1,6,30023,173,5,W
2002-09-16,2,BOS,7,1,31203,170,-6,NW
2002-09-17,0,BOS,2,4,31760,126,2,W
2002-09-18,0,BOS,6,4,31829,172,-2,NW
2002-09-27,0,BOS,1,6,32423,150,5,W
2002-09-28,0,BOS,9,6,32623,154,-3,NW
2002-09-29,0,BOS,8,11,32194,180,3,W
2003-04-12,0,BOS,13,6,32029,198,-7,NW
2003-04-13,0,BOS,0,2,32368,150,2,W
2003-04-15,0,BOS,5,6,29617,167,1,W
2003-04-16,0,BOS,4,6,26688,160,2,W
2003-04-17,0,BOS,0,6,30909,145,6,W
2003-04-18,0,BOS,3,7,31440,179,4,W
2003-04-19,0,BOS,2,7,32329,210,5,W
2003-04-20,0,BOS,5,6,29579,163,1,W
2003-04-21,0,BOS,11,6,34370,198,-5,NW
2003-04-29,0,BOS,2,7,30438,161,5,W
2003-04-30,0,BOS,4,5,31334,186,1,W
2003-05-01,0,BOS,5,6,31950,177,1,W
2003-05-02,0,BOS,11,7,31317,194,-4,NW
2003-05-03,0,BOS,1,9,33061,146,8,W
2003-05-04,0,BOS,9,4,32887,176,-5,NW
2003-05-13,0,BOS,4,5,31956,159,1,W
2003-05-14,0,BOS,1,7,32485,185,6,W
2003-05-15,0,BOS,3,12,33801,173,9,W
2003-05-16,0,BOS,6,5,33170,187,-1,NW
2003-05-17,0,BOS,6,2,33327,174,-4,NW
2003-05-18,0,BOS,3,5,33347,163,2,W
2003-05-19,0,BOS,7,3,35099,203,-4,NW
2003-05-20,0,BOS,7,10,35007,181,3,W
2003-05-21,0,BOS,4,2,35003,177,-2,NW
2003-05-23,0,BOS,2,9,32673,128,7,W
2003-05-24,0,BOS,3,12,32643,166,9,W
2003-05-25,0,BOS,6,4,34318,163,-2,NW
2003-06-10,0,BOS,9,7,34937,211,-2,NW
2003-06-11,0,BOS,1,13,33453,171,12,W
2003-06-12,0,BOS,8,7,34389,273,-1,NW
2003-06-13,0,BOS,3,4,33244,184,1,W
2003-06-14,0,BOS,4,8,34562,157,4,W
2003-06-15,0,BOS,2,3,34085,278,1,W
2003-06-23,0,BOS,1,3,33814,155,2,W
2003-06-24,0,BOS,1,10,33848,157,9,W
2003-06-25,0,BOS,2,11,33587,175,9,W
2003-06-26,0,BOS,4,6,34415,152,2,W
2003-06-27,0,BOS,8,25,34764,247,17,W
2003-06-28,0,BOS,10,9,34804,173,-1,NW
2003-06-29,0,BOS,7,11,34476,172,4,W
2003-07-17,0,BOS,5,2,34521,162,-3,NW
2003-07-18,0,BOS,4,1,34136,160,-3,NW
2003-07-19,0,BOS,4,5,34812,208,1,W
2003-07-20,0,BOS,4,9,34321,162,5,W
2003-07-21,0,BOS,5,14,33823,158,9,W
2003-07-22,0,BOS,4,7,33570,133,3,W
2003-07-23,0,BOS,4,10,33446,160,6,W
2003-07-24,0,BOS,15,9,33521,174,-6,NW
2003-07-25,0,BOS,4,3,34873,221,-1,NW
2003-07-26,0,BOS,4,5,34356,199,1,W
2003-07-27,0,BOS,4,6,34787,201,2,W
2003-08-05,0,BOS,9,10,34678,196,1,W
2003-08-06,0,BOS,2,4,35040,176,2,W
2003-08-07,0,BOS,3,9,34570,174,6,W
2003-08-08,1,BOS,10,4,35099,162,-6,NW
2003-08-08,2,BOS,4,2,34595,177,-2,NW
2003-08-09,0,BOS,4,6,34883,144,2,W
2003-08-10,0,BOS,5,3,34239,176,-2,NW
2003-08-19,0,BOS,3,2,34879,171,-1,NW
2003-08-20,0,BOS,8,6,34798,218,-2,NW
2003-08-21,0,BOS,5,14,34844,173,9,W
2003-08-22,0,BOS,4,6,34379,193,2,W
2003-08-23,0,BOS,6,7,34488,227,1,W
2003-08-24,0,BOS,1,6,34344,161,5,W
2003-08-25,0,BOS,1,8,33007,170,7,W
2003-08-26,0,BOS,12,9,33731,218,-3,NW
2003-08-27,0,BOS,3,6,34206,154,3,W
2003-08-29,0,BOS,5,10,34854,191,5,W
2003-08-30,0,BOS,10,7,34350,222,-3,NW
2003-08-31,0,BOS,8,4,34482,193,-4,NW
2003-09-12,0,BOS,4,7,34890,194,3,W
2003-09-13,0,BOS,3,1,34414,141,-2,NW
2003-09-14,0,BOS,7,2,34174,156,-5,NW
2003-09-15,0,BOS,2,8,33389,154,6,W
2003-09-16,0,BOS,2,3,33618,154,1,W
2003-09-17,0,BOS,7,0,33806,191,-7,NW
2003-09-18,0,BOS,3,4,34042,137,1,W
2003-09-22,0,BOS,5,7,33821,188,2,W
2003-09-23,0,BOS,5,6,33723,190,1,W
2003-09-24,0,BOS,7,3,34607,168,-4,NW
2003-09-25,0,BOS,3,14,34526,180,11,W
2004-04-09,0,BOS,10,5,34337,176,-5,NW
2004-04-10,0,BOS,1,4,35305,133,3,W
2004-04-11,0,BOS,4,6,34286,233,2,W
2004-04-15,0,BOS,12,7,35271,268,-5,NW
2004-04-16,0,BOS,2,6,35163,187,4,W
2004-04-17,0,BOS,2,5,35023,185,3,W
2004-04-18,0,BOS,7,3,35011,200,-4,NW
2004-04-19,0,BOS,4,5,35027,173,1,W
2004-04-28,0,BOS,0,6,35120,156,6,W
2004-04-29,1,BOS,0,4,35614,157,4,W
2004-04-29,2,BOS,3,7,35441,166,4,W
2004-05-07,0,BOS,6,7,35280,167,1,W
2004-05-08,0,BOS,1,9,34929,164,8,W
2004-05-09,0,BOS,8,4,34589,200,-4,NW
2004-05-10,0,BOS,10,6,35257,218,-4,NW
2004-05-11,0,BOS,3,5,35401,152,2,W
2004-05-12,0,BOS,6,4,35371,169,-2,NW
2004-05-21,0,BOS,5,11,35287,165,6,W
2004-05-22,0,BOS,2,5,35196,174,3,W
2004-05-23,0,BOS,2,7,35239,159,5,W
2004-05-25,0,BOS,2,12,35236,195,10,W
2004-05-26,0,BOS,6,9,34931,193,3,W
2004-05-27,0,BOS,15,2,35438,190,-13,NW
2004-05-28,0,BOS,4,8,35134,162,4,W
2004-05-29,0,BOS,5,4,35250,190,-1,NW
2004-05-30,0,BOS,7,9,35046,234,2,W
2004-05-31,0,BOS,13,4,35465,211,-9,NW
2004-06-08,0,BOS,0,1,35205,147,1,W
2004-06-09,0,BOS,8,1,35064,164,-7,NW
2004-06-10,0,BOS,3,9,35068,171,6,W
2004-06-11,0,BOS,1,2,35173,152,1,W
2004-06-12,0,BOS,14,5,34671,205,-9,NW
2004-06-13,0,BOS,1,4,35068,180,3,W
2004-06-22,0,BOS,2,9,35261,168,7,W
2004-06-23,0,BOS,4,2,35233,163,-2,NW
2004-06-24,0,BOS,4,3,34827,168,-1,NW
2004-06-25,0,BOS,1,12,35059,147,11,W
2004-06-26,0,BOS,9,2,34712,191,-7,NW
2004-06-27,0,BOS,3,12,34739,176,9,W
2004-07-06,0,BOS,0,11,35302,169,11,W
2004-07-07,0,BOS,3,11,35012,156,8,W
2004-07-08,0,BOS,7,8,35144,213,1,W
2004-07-09,0,BOS,0,7,35030,149,7,W
2004-07-10,0,BOS,6,14,35024,185,8,W
2004-07-11,0,BOS,6,5,34778,184,-1,NW
2004-07-21,0,BOS,10,5,35023,187,-5,NW
2004-07-22,1,BOS,8,3,34697,167,-5,NW
2004-07-22,2,BOS,0,4,35370,151,4,W
2004-07-23,0,BOS,8,7,34933,205,-1,NW
2004-07-24,0,BOS,10,11,34501,234,1,W
2004-07-25,0,BOS,6,9,35006,215,3,W
2004-08-09,0,BOS,8,3,35172,190,-5,NW
2004-08-10,0,BOS,4,8,35191,156,4,W
2004-08-11,0,BOS,4,14,35091,179,10,W
2004-08-12,0,BOS,0,6,34804,143,6,W
2004-08-13,0,BOS,8,7,35028,203,-1,NW
2004-08-14,0,BOS,3,4,35012,154,1,W
2004-08-15,0,BOS,5,4,34405,173,-1,NW
2004-08-16,0,BOS,4,8,35271,179,4,W
2004-08-17,0,BOS,4,5,35105,161,1,W
2004-08-18,0,BOS,4,6,34867,148,2,W
2004-08-26,0,BOS,1,4,35153,170,3,W
2004-08-27,0,BOS,3,5,35018,167,2,W
2004-08-28,0,BOS,1,5,35032,158,4,W
2004-08-29,0,BOS,1,6,34268,146,5,W
2004-08-31,0,BOS,7,10,35040,180,3,W
2004-09-01,0,BOS,7,12,35076,197,5,W
2004-09-02,0,BOS,3,4,35050,197,1,W
2004-09-03,0,BOS,0,2,35151,177,2,W
2004-09-04,0,BOS,8,6,34670,196,-2,NW
2004-09-05,0,BOS,5,6,34652,163,1,W
2004-09-14,0,BOS,5,2,35118,188,-3,NW
2004-09-15,0,BOS,6,8,35105,208,2,W
2004-09-16,0,BOS,4,11,35048,170,7,W
2004-09-20,0,BOS,9,6,34758,192,-3,NW
2004-09-21,0,BOS,2,3,35083,181,1,W
2004-09-22,0,BOS,6,7,35103,254,1,W
2004-09-23,0,BOS,9,7,35026,207,-2,NW
2004-09-24,0,BOS,6,4,35022,198,-2,NW
2004-09-25,0,BOS,5,12,34856,203,7,W
2004-09-26,0,BOS,4,11,34582,195,7,W
2005-04-11,0,BOS,1,8,33702,169,7,W
2005-04-13,0,BOS,5,2,35115,188,-3,NW
2005-04-14,0,BOS,5,8,35251,193,3,W
2005-04-15,0,BOS,0,10,35023,168,10,W
2005-04-16,0,BOS,2,6,35106,168,4,W
2005-04-17,0,BOS,1,3,35232,155,2,W
2005-04-18,0,BOS,7,12,35243,221,5,W
2005-04-19,0,BOS,4,3,35598,149,-1,NW
2005-04-25,0,BOS,8,4,35003,198,-4,NW
2005-04-26,0,BOS,11,8,35670,243,-3,NW
2005-05-06,0,BOS,2,7,35229,185,5,W
2005-05-08,1,BOS,3,6,34848,153,3,W
2005-05-08,2,BOS,6,4,34671,184,-2,NW
2005-05-09,0,BOS,5,13,35000,183,8,W
2005-05-10,0,BOS,2,3,35644,163,1,W
2005-05-11,0,BOS,5,6,35375,189,1,W
2005-05-20,0,BOS,3,4,35332,157,1,W
2005-05-21,0,BOS,7,5,35008,187,-2,NW
2005-05-22,0,BOS,2,5,34844,166,3,W
2005-05-30,0,BOS,8,1,35483,181,-7,NW
2005-05-31,0,BOS,1,5,35147,168,4,W
2005-06-01,0,BOS,9,3,35527,181,-6,NW
2005-06-02,0,BOS,4,6,35138,203,2,W
2005-06-03,0,BOS,4,7,35328,185,3,W
2005-06-04,0,BOS,13,6,34754,231,-7,NW
2005-06-05,0,BOS,3,6,35008,172,3,W
2005-06-13,0,BOS,3,10,35478,165,7,W
2005-06-14,0,BOS,0,7,35387,163,7,W
2005-06-15,0,BOS,1,6,35265,172,5,W
2005-06-17,0,BOS,5,6,35377,184,1,W
2005-06-18,0,BOS,2,0,35216,178,-2,NW
2005-06-19,0,BOS,0,8,35046,167,8,W
2005-06-27,0,BOS,7,0,35458,180,-7,NW
2005-06-28,0,BOS,12,8,35445,217,-4,NW
2005-06-29,0,BOS,2,5,35069,175,3,W
2005-07-01,0,BOS,15,2,35302,207,-13,NW
2005-07-02,0,BOS,4,6,35268,197,2,W
2005-07-03,0,BOS,5,2,34794,167,-3,NW
2005-07-14,0,BOS,8,6,35232,194,-2,NW
2005-07-15,0,BOS,1,17,35083,181,16,W
2005-07-16,0,BOS,7,4,34694,214,-3,NW
2005-07-17,0,BOS,5,3,34802,162,-2,NW
2005-07-18,0,BOS,3,1,35405,187,-2,NW
2005-07-19,0,BOS,2,5,35428,160,3,W
2005-07-20,0,BOS,4,9,35123,169,5,W
2005-07-29,0,BOS,5,8,35211,150,3,W
2005-07-30,0,BOS,2,6,35167,178,4,W
2005-07-31,0,BOS,3,4,34929,183,1,W
2005-08-02,0,BOS,4,6,35386,163,2,W
2005-08-03,0,BOS,5,8,35055,183,3,W
2005-08-04,0,BOS,9,11,35060,198,2,W
2005-08-08,0,BOS,6,11,35453,198,5,W
2005-08-09,0,BOS,7,8,35308,253,1,W
2005-08-10,0,BOS,5,16,35379,211,11,W
2005-08-12,0,BOS,8,9,35132,177,1,W
2005-08-13,0,BOS,4,7,35055,169,3,W
2005-08-26,0,BOS,8,9,35056,189,1,W
2005-08-27,0,BOS,12,8,35228,217,-4,NW
2005-08-28,0,BOS,3,11,34568,170,8,W
2005-08-29,0,BOS,6,10,35007,196,4,W
2005-08-30,0,BOS,6,7,35101,206,1,W
2005-08-31,0,BOS,6,7,35253,144,1,W
2005-09-01,0,BOS,4,7,35337,151,3,W
2005-09-02,0,BOS,7,3,35156,186,-4,NW
2005-09-03,0,BOS,6,7,35142,183,1,W
2005-09-04,0,BOS,1,5,35003,140,4,W
2005-09-05,0,BOS,5,3,35673,191,-2,NW
2005-09-06,0,BOS,2,3,35061,166,1,W
2005-09-07,0,BOS,3,6,35423,154,3,W
2005-09-08,0,BOS,3,0,35351,198,-3,NW
2005-09-15,0,BOS,6,2,35079,183,-4,NW
2005-09-16,0,BOS,2,3,35249,187,1,W
2005-09-17,0,BOS,1,2,35220,149,1,W
2005-09-18,0,BOS,12,3,34849,156,-9,NW
2005-09-27,1,BOS,1,3,35700,143,2,W
2005-09-27,2,BOS,7,5,35476,222,-2,NW
2005-09-28,0,BOS,7,2,35313,195,-5,NW
2005-09-29,0,BOS,4,5,35345,204,1,W
2005-09-30,0,BOS,3,5,34832,188,2,W
2005-10-01,0,BOS,8,4,34556,181,-4,NW
2005-10-02,0,BOS,1,10,34534,216,9,W
2006-04-11,0,BOS,3,5,35491,164,2,W
2006-04-12,0,BOS,8,4,36378,180,-4,NW
2006-04-13,0,BOS,8,6,36524,182,-2,NW
2006-04-14,0,BOS,1,2,36431,168,1,W
2006-04-15,0,BOS,3,0,36047,147,-3,NW
2006-04-16,0,BOS,2,3,36181,163,1,W
2006-04-17,0,BOS,6,7,36188,175,1,W
2006-04-18,0,BOS,4,7,36423,195,3,W
2006-04-19,0,BOS,1,9,36454,175,8,W
2006-04-20,0,BOS,5,1,36607,163,-4,NW
2006-05-01,0,BOS,3,7,36339,184,4,W
2006-05-03,0,BOS,7,6,35881,218,-1,NW
2006-05-04,0,BOS,4,7,36396,172,3,W
2006-05-05,0,BOS,3,6,36515,167,3,W
2006-05-06,0,BOS,3,9,36507,201,6,W
2006-05-07,0,BOS,3,10,36022,179,7,W
2006-05-12,0,BOS,6,0,36102,130,-6,NW
2006-05-22,0,BOS,5,9,36342,163,4,W
2006-05-23,0,BOS,7,5,36290,198,-2,NW
2006-05-24,0,BOS,8,6,36375,210,-2,NW
2006-05-25,0,BOS,1,4,36209,197,3,W
2006-05-26,0,BOS,4,8,36129,192,4,W
2006-05-27,0,BOS,4,6,36409,166,2,W
2006-05-28,0,BOS,4,5,36015,174,1,W
2006-06-09,0,BOS,3,4,36133,138,1,W
2006-06-10,0,BOS,7,4,36920,205,-3,NW
2006-06-11,1,BOS,4,5,36232,205,1,W
2006-06-11,2,BOS,13,6,35602,209,-7,NW
2006-06-19,0,BOS,3,6,36252,199,3,W
2006-06-20,0,BOS,3,11,36421,175,8,W
2006-06-21,0,BOS,3,9,36464,177,6,W
2006-06-23,0,BOS,2,10,35948,170,8,W
2006-06-24,0,BOS,3,5,35564,219,2,W
2006-06-26,0,BOS,7,8,36459,299,1,W
2006-06-27,0,BOS,4,9,36250,193,5,W
2006-06-28,0,BOS,2,10,36035,170,8,W
2006-06-29,0,BOS,2,4,36028,166,2,W
2006-07-13,0,BOS,5,4,36141,263,-1,NW
2006-07-14,0,BOS,15,3,36319,220,-12,NW
2006-07-15,0,BOS,0,7,36232,177,7,W
2006-07-16,0,BOS,8,1,35643,189,-7,NW
2006-07-17,0,BOS,4,5,36436,176,1,W
2006-07-18,0,BOS,0,1,36224,143,1,W
2006-07-19,0,BOS,0,1,36098,155,1,W
2006-07-20,0,BOS,4,6,36489,178,2,W
2006-07-28,0,BOS,8,3,36109,193,-5,NW
2006-07-29,0,BOS,6,7,35621,239,1,W
2006-07-30,0,BOS,10,4,36048,187,-6,NW
2006-07-31,0,BOS,8,9,36387,195,1,W
2006-08-01,0,BOS,6,3,36328,183,-3,NW
2006-08-02,0,BOS,5,6,36022,201,1,W
2006-08-03,0,BOS,7,6,36557,176,-1,NW
2006-08-11,0,BOS,2,9,36191,181,7,W
2006-08-12,0,BOS,7,8,35768,205,1,W
2006-08-13,0,BOS,9,11,35744,221,2,W
2006-08-14,0,BOS,7,4,36392,185,-3,NW
2006-08-15,0,BOS,3,2,36179,174,-1,NW
2006-08-16,0,BOS,4,6,36304,167,2,W
2006-08-18,1,BOS,12,4,36325,235,-8,NW
2006-08-18,2,BOS,14,11,36071,285,-3,NW
2006-08-19,0,BOS,13,5,35738,221,-8,NW
2006-08-20,0,BOS,8,5,36155,257,-3,NW
2006-08-21,0,BOS,2,1,35829,183,-1,NW
2006-08-31,0,BOS,4,6,36238,179,2,W
2006-09-01,0,BOS,1,2,36235,181,1,W
2006-09-02,0,BOS,5,1,35973,166,-4,NW
2006-09-03,0,BOS,6,1,35719,189,-5,NW
2006-09-04,0,BOS,2,3,36206,187,1,W
2006-09-05,0,BOS,0,1,35912,133,1,W
2006-09-06,0,BOS,8,1,35923,167,-7,NW
2006-09-08,0,BOS,10,9,36531,222,-1,NW
2006-09-09,0,BOS,10,4,36402,258,-6,NW
2006-09-10,0,BOS,3,9,35703,201,6,W
2006-09-19,0,BOS,7,3,36242,183,-4,NW
2006-09-20,0,BOS,8,2,36484,195,-6,NW
2006-09-21,0,BOS,0,6,36434,174,6,W
2006-09-26,0,BOS,1,5,36134,159,4,W
2006-09-27,0,BOS,11,0,36028,165,-11,NW
2006-09-29,0,BOS,3,4,36269,178,1,W
2006-09-30,0,BOS,5,4,36596,171,-1,NW
2006-10-01,0,BOS,0,9,35826,97,9,W
2007-04-10,0,BOS,3,14,35847,186,11,W
2007-04-11,0,BOS,3,0,36630,142,-3,NW
2007-04-13,0,BOS,1,10,35946,169,9,W
2007-04-14,0,BOS,0,8,36300,186,8,W
2007-04-16,0,BOS,2,7,35424,152,5,W
2007-04-20,0,BOS,6,7,36786,198,1,W
2007-04-21,0,BOS,5,7,36342,206,2,W
2007-04-22,0,BOS,6,7,36905,214,1,W
2007-04-23,0,BOS,7,3,36669,182,-4,NW
2007-04-24,0,BOS,10,3,37161,171,-7,NW
2007-05-01,0,BOS,5,4,37052,196,-1,NW
2007-05-02,0,BOS,4,6,37006,191,2,W
2007-05-03,0,BOS,7,8,37216,206,1,W
2007-05-11,0,BOS,6,3,37039,201,-3,NW
2007-05-12,0,BOS,4,13,36503,244,9,W
2007-05-13,0,BOS,5,6,36379,190,1,W
2007-05-14,0,BOS,1,7,36935,173,6,W
2007-05-15,0,BOS,7,2,37031,165,-5,NW
2007-05-17,1,BOS,1,2,36767,168,1,W
2007-05-17,2,BOS,2,4,37006,188,2,W
2007-05-19,1,BOS,3,13,36358,182,10,W
2007-05-19,2,BOS,14,0,36792,181,-14,NW
2007-05-20,0,BOS,3,6,36140,185,3,W
2007-05-28,0,BOS,3,5,36910,195,2,W
2007-05-29,0,BOS,2,4,37076,176,2,W
2007-05-30,0,BOS,8,4,37091,214,-4,NW
2007-06-01,0,BOS,9,5,36785,233,-4,NW
2007-06-02,0,BOS,6,11,36294,219,5,W
2007-06-03,0,BOS,6,5,36793,244,-1,NW
2007-06-12,0,BOS,1,2,37008,145,1,W
2007-06-13,0,BOS,12,2,36808,189,-10,NW
2007-06-14,0,BOS,7,1,36939,194,-6,NW
2007-06-15,0,BOS,2,10,36508,189,8,W
2007-06-16,0,BOS,0,1,36381,170,1,W
2007-06-17,0,BOS,5,9,36137,176,4,W
2007-06-29,0,BOS,1,2,36756,190,1,W
2007-06-30,0,BOS,5,4,36747,196,-1,NW
2007-07-01,0,BOS,2,1,36378,204,-1,NW
2007-07-02,0,BOS,3,7,36778,198,4,W
2007-07-03,0,BOS,1,4,37005,178,3,W
2007-07-04,0,BOS,5,7,36629,153,2,W
2007-07-05,0,BOS,4,15,37044,216,11,W
2007-07-12,0,BOS,4,7,36887,185,3,W
2007-07-13,0,BOS,6,5,36908,231,-1,NW
2007-07-14,0,BOS,4,9,36830,193,5,W
2007-07-15,0,BOS,2,1,36301,172,-1,NW
2007-07-16,0,BOS,0,4,37099,138,4,W
2007-07-17,0,BOS,9,3,37001,196,-6,NW
2007-07-18,0,BOS,6,5,36681,188,-1,NW
2007-07-19,0,BOS,4,2,36913,214,-2,NW
2007-07-20,0,BOS,3,10,36737,173,7,W
2007-07-21,0,BOS,2,11,36283,185,9,W
2007-07-22,0,BOS,5,8,36346,194,3,W
2007-07-31,0,BOS,5,3,36866,196,-2,NW
2007-08-01,0,BOS,4,5,36649,201,1,W
2007-08-02,0,BOS,4,7,36457,166,3,W
2007-08-13,0,BOS,0,3,36808,163,3,W
2007-08-14,0,BOS,1,2,36837,183,1,W
2007-08-15,0,BOS,6,5,36413,207,-1,NW
2007-08-17,1,BOS,4,8,36686,198,4,W
2007-08-17,2,BOS,7,5,36538,194,-2,NW
2007-08-18,0,BOS,5,10,36652,195,5,W
2007-08-19,0,BOS,3,1,36346,169,-2,NW
2007-08-31,0,BOS,9,8,36810,230,-1,NW
2007-09-01,0,BOS,0,10,36819,182,10,W
2007-09-02,0,BOS,2,3,36340,155,1,W
2007-09-03,0,BOS,10,13,36639,239,3,W
2007-09-04,0,BOS,3,5,36839,152,2,W
2007-09-05,0,BOS,6,4,37106,206,-2,NW
2007-09-10,0,BOS,1,0,36907,176,-1,NW
2007-09-11,0,BOS,10,16,36640,225,6,W
2007-09-12,0,BOS,4,5,36931,206,1,W
2007-09-14,0,BOS,8,7,36590,283,-1,NW
2007-09-15,0,BOS,1,10,36215,217,9,W
2007-09-16,0,BOS,4,3,36533,190,-1,NW
2007-09-25,0,BOS,3,7,36708,202,4,W
2007-09-26,0,BOS,6,11,36570,207,5,W
2007-09-27,0,BOS,5,4,36743,194,-1,NW
2007-09-28,0,BOS,2,5,36843,153,3,W
2007-09-29,0,BOS,4,6,36619,137,2,W
2007-09-30,0,BOS,3,2,36364,167,-1,NW
2008-04-08,0,BOS,0,5,36567,209,5,W
2008-04-09,0,BOS,7,2,37190,225,-5,NW
2008-04-10,0,BOS,6,12,37612,224,6,W
2008-04-11,0,BOS,4,1,37624,179,-3,NW
2008-04-12,0,BOS,3,4,37461,169,1,W
2008-04-13,0,BOS,5,8,37876,235,3,W
2008-04-18,0,BOS,3,11,37902,193,8,W
2008-04-19,0,BOS,3,5,37958,176,2,W
2008-04-20,0,BOS,5,6,37480,160,1,W
2008-04-21,0,BOS,3,8,37539,213,5,W
2008-04-22,0,BOS,6,7,37982,201,1,W
2008-04-23,0,BOS,6,4,38172,172,-2,NW
2008-04-24,0,BOS,7,5,37848,197,-2,NW
2008-04-29,0,BOS,0,1,37215,138,1,W
2008-04-30,0,BOS,1,2,37710,180,1,W
2008-05-01,0,BOS,3,0,37821,164,-3,NW
2008-05-02,0,BOS,3,7,37541,196,4,W
2008-05-03,0,BOS,4,12,37700,193,8,W
2008-05-04,0,BOS,3,7,37091,219,4,W
2008-05-17,1,BOS,3,5,37409,183,2,W
2008-05-17,2,BOS,6,7,37847,192,1,W
2008-05-18,0,BOS,7,11,37204,198,4,W
2008-05-19,0,BOS,0,7,37746,150,7,W
2008-05-20,0,BOS,1,2,37486,170,1,W
2008-05-21,0,BOS,3,6,37674,199,3,W
2008-05-22,0,BOS,8,11,37613,196,3,W
2008-06-03,0,BOS,4,7,37823,174,3,W
2008-06-04,0,BOS,1,5,37474,193,4,W
2008-06-05,0,BOS,1,7,37639,220,6,W
2008-06-06,0,BOS,8,0,37757,158,-8,NW
2008-06-07,0,BOS,3,11,37443,165,8,W
2008-06-08,0,BOS,1,2,37198,166,1,W
2008-06-10,0,BOS,10,6,37858,207,-4,NW
2008-06-11,0,BOS,3,6,38130,167,3,W
2008-06-12,0,BOS,2,9,38139,158,7,W
2008-06-20,0,BOS,5,4,37671,179,-1,NW
2008-06-21,0,BOS,9,3,37227,172,-6,NW
2008-06-22,0,BOS,3,5,37085,265,2,W
2008-06-23,0,BOS,2,1,37694,181,-1,NW
2008-06-24,0,BOS,4,5,37867,164,1,W
2008-06-25,0,BOS,0,5,37924,168,5,W
2008-07-07,0,BOS,0,1,37912,163,1,W
2008-07-08,0,BOS,5,6,37925,171,1,W
2008-07-09,0,BOS,5,18,37470,239,13,W
2008-07-11,0,BOS,7,3,37779,209,-4,NW
2008-07-12,0,BOS,1,12,37539,152,11,W
2008-07-13,0,BOS,1,2,37344,212,1,W
2008-07-25,0,BOS,1,0,37744,184,-1,NW
2008-07-26,0,BOS,10,3,37225,208,-7,NW
2008-07-27,0,BOS,2,9,37688,170,7,W
2008-07-28,0,BOS,7,5,37830,192,-2,NW
2008-07-29,0,BOS,6,2,38110,148,-4,NW
2008-07-30,0,BOS,9,2,38042,183,-7,NW
2008-08-01,0,BOS,1,2,37832,230,1,W
2008-08-02,0,BOS,2,12,37838,152,10,W
2008-08-03,0,BOS,2,5,37317,183,3,W
2008-08-12,0,BOS,17,19,38004,238,2,W
2008-08-13,0,BOS,4,8,37876,173,4,W
2008-08-14,0,BOS,0,10,37856,176,10,W
2008-08-16,0,BOS,4,1,37834,138,-3,NW
2008-08-17,0,BOS,15,4,37415,207,-11,NW
2008-08-29,0,BOS,0,8,37755,168,8,W
2008-08-30,0,BOS,2,8,37751,160,6,W
2008-08-31,0,BOS,4,2,37391,167,-2,NW
2008-09-01,0,BOS,4,7,37565,170,3,W
2008-09-02,0,BOS,2,14,37710,204,12,W
2008-09-03,0,BOS,4,5,37373,183,1,W
2008-09-08,0,BOS,0,3,37662,158,3,W
2008-09-09,0,BOS,5,4,37573,220,-1,NW
2008-09-10,0,BOS,4,2,38114,302,-2,NW
2008-09-12,0,BOS,0,7,37398,160,7,W
2008-09-13,1,BOS,8,1,37341,155,-7,NW
2008-09-13,2,BOS,5,7,37846,181,2,W
2008-09-14,0,BOS,3,4,37007,153,1,W
2008-09-22,0,BOS,4,3,37828,189,-1,NW
2008-09-23,0,BOS,4,5,37882,171,1,W
2008-09-24,0,BOS,4,5,37719,179,1,W
2008-09-25,0,BOS,1,6,37726,152,5,W
2008-09-26,0,BOS,19,8,37301,218,-11,NW
2008-09-28,1,BOS,6,2,37091,196,-4,NW
2008-09-28,2,BOS,3,4,37440,190,1,W
2009-04-07,0,BOS,3,5,37057,159,2,W
2009-04-08,0,BOS,7,2,37552,190,-5,NW
2009-04-09,0,BOS,4,3,37784,219,-1,NW
2009-04-17,0,BOS,8,10,38266,214,2,W
2009-04-18,0,BOS,4,6,37559,193,2,W
2009-04-19,0,BOS,1,2,37869,151,1,W
2009-04-20,0,BOS,1,12,37865,193,11,W
2009-04-22,1,BOS,1,10,37608,131,9,W
2009-04-22,2,BOS,3,7,37494,148,4,W
2009-04-24,0,BOS,4,5,38163,261,1,W
2009-04-25,0,BOS,11,16,37699,261,5,W
2009-04-26,0,BOS,1,4,38154,189,3,W
2009-05-06,0,BOS,9,2,37888,173,-7,NW
2009-05-07,0,BOS,3,13,37541,155,10,W
2009-05-08,0,BOS,3,7,37745,172,4,W
2009-05-09,0,BOS,14,5,37773,213,-9,NW
2009-05-10,0,BOS,3,4,37759,210,1,W
2009-05-19,0,BOS,1,2,37830,133,1,W
2009-05-20,0,BOS,3,8,38099,178,5,W
2009-05-21,0,BOS,1,5,38347,175,4,W
2009-05-22,0,BOS,5,3,38092,170,-2,NW
2009-05-23,0,BOS,3,2,37871,169,-1,NW
2009-05-24,0,BOS,5,12,37446,177,7,W
2009-06-05,0,BOS,5,1,37519,181,-4,NW
2009-06-06,0,BOS,1,8,37828,145,7,W
2009-06-07,0,BOS,6,3,37537,169,-3,NW
2009-06-09,0,BOS,0,7,37883,184,7,W
2009-06-10,0,BOS,5,6,38121,203,1,W
2009-06-11,0,BOS,3,4,38153,219,1,W
2009-06-16,0,BOS,2,8,38149,150,6,W
2009-06-17,0,BOS,1,6,38196,190,5,W
2009-06-18,0,BOS,2,1,37577,104,-1,NW
2009-06-19,0,BOS,8,2,37703,169,-6,NW
2009-06-20,0,BOS,0,3,38029,131,3,W
2009-06-21,0,BOS,5,6,37243,167,1,W
2009-07-03,0,BOS,7,6,38078,189,-1,NW
2009-07-04,0,BOS,3,2,37656,186,-1,NW
2009-07-05,0,BOS,4,8,37691,177,4,W
2009-07-06,0,BOS,6,0,38294,154,-6,NW
2009-07-07,0,BOS,2,5,37676,193,3,W
2009-07-08,0,BOS,4,5,37981,183,1,W
2009-07-09,0,BOS,8,6,38189,212,-2,NW
2009-07-10,0,BOS,0,1,38116,149,1,W
2009-07-11,0,BOS,9,15,37825,224,6,W
2009-07-12,0,BOS,0,6,37612,172,6,W
2009-07-24,0,BOS,1,3,38058,173,2,W
2009-07-25,0,BOS,2,7,38063,152,5,W
2009-07-26,0,BOS,6,2,37606,158,-4,NW
2009-07-27,0,BOS,3,8,37955,176,5,W
2009-07-28,0,BOS,9,8,38084,248,-1,NW
2009-07-29,0,BOS,8,6,38193,198,-2,NW
2009-07-30,0,BOS,5,8,37919,197,3,W
2009-08-10,0,BOS,5,6,37960,205,1,W
2009-08-11,0,BOS,5,7,38013,191,2,W
2009-08-12,0,BOS,2,8,38124,177,6,W
2009-08-13,0,BOS,2,0,37556,164,-2,NW
2009-08-21,0,BOS,20,11,37869,237,-9,NW
2009-08-22,0,BOS,1,14,37277,197,13,W
2009-08-23,0,BOS,8,4,38008,193,-4,NW
2009-08-24,0,BOS,8,12,37812,222,4,W
2009-08-25,0,BOS,3,6,38059,185,3,W
2009-08-26,0,BOS,2,3,37839,149,1,W
2009-08-27,0,BOS,9,5,38003,184,-4,NW
2009-08-28,0,BOS,5,6,37844,220,1,W
2009-08-29,0,BOS,2,3,37452,193,1,W
2009-08-30,0,BOS,0,7,37560,158,7,W
2009-09-08,0,BOS,0,10,37647,162,10,W
2009-09-09,0,BOS,5,7,37712,221,2,W
2009-09-12,0,BOS,1,9,37755,104,8,W
2009-09-13,1,BOS,1,3,38228,165,2,W
2009-09-13,2,BOS,0,4,37271,155,4,W
2009-09-15,0,BOS,1,4,37942,164,3,W
2009-09-16,0,BOS,8,9,37706,247,1,W
2009-09-17,0,BOS,4,3,38157,158,-1,NW
2009-09-28,0,BOS,11,5,37591,142,-6,NW
2009-09-29,0,BOS,8,7,37618,191,-1,NW
2009-09-30,0,BOS,12,0,37246,158,-12,NW
2009-10-01,0,BOS,0,3,37459,165,3,W
2009-10-02,0,BOS,2,6,37787,205,4,W
2009-10-03,0,BOS,6,11,37562,170,5,W
2009-10-04,0,BOS,7,12,37247,195,5,W
2010-04-04,0,BOS,7,9,37440,226,2,W
2010-04-06,0,BOS,6,4,38000,228,-2,NW
2010-04-07,0,BOS,3,1,38238,201,-2,NW
2010-04-16,0,BOS,3,1,37084,258,-2,NW
2010-04-17,0,BOS,6,5,37022,199,-1,NW
2010-04-18,0,BOS,7,1,37143,185,-6,NW
2010-04-19,0,BOS,8,2,37609,169,-6,NW
2010-04-20,0,BOS,6,7,37614,226,1,W
2010-04-21,0,BOS,7,8,37518,229,1,W
2010-04-22,0,BOS,3,0,37417,178,-3,NW
2010-04-23,0,BOS,3,4,37367,215,1,W
2010-04-24,0,BOS,6,7,38017,188,1,W
2010-04-25,0,BOS,7,6,37102,224,-1,NW
2010-05-03,0,BOS,8,17,37404,218,9,W
2010-05-04,0,BOS,1,5,37411,176,4,W
2010-05-05,0,BOS,1,3,37601,153,2,W
2010-05-06,0,BOS,6,11,37639,223,5,W
2010-05-07,0,BOS,10,3,37898,181,-7,NW
2010-05-08,0,BOS,14,3,37138,236,-11,NW
2010-05-09,0,BOS,3,9,37618,185,6,W
2010-05-10,0,BOS,6,7,37332,186,1,W
2010-05-11,0,BOS,1,6,37609,184,5,W
2010-05-12,0,BOS,3,2,37198,152,-1,NW
2010-05-19,0,BOS,2,3,37426,179,1,W
2010-05-20,0,BOS,2,6,38144,152,4,W
2010-05-27,0,BOS,4,3,37940,183,-1,NW
2010-05-28,0,BOS,12,5,37945,185,-7,NW
2010-05-29,0,BOS,0,1,37956,166,1,W
2010-05-30,0,BOS,1,8,37581,166,7,W
2010-06-01,0,BOS,4,9,37337,209,5,W
2010-06-02,0,BOS,4,6,37783,173,2,W
2010-06-03,0,BOS,9,8,37386,197,-1,NW
2010-06-11,0,BOS,2,12,38021,163,10,W
2010-06-12,0,BOS,2,10,37061,200,8,W
2010-06-13,0,BOS,5,3,37230,177,-2,NW
2010-06-15,0,BOS,3,6,37459,182,3,W
2010-06-16,0,BOS,2,6,37452,168,4,W
2010-06-17,0,BOS,5,8,37544,204,3,W
2010-06-18,0,BOS,6,10,37723,198,4,W
2010-06-19,0,BOS,4,5,37454,187,1,W
2010-06-20,0,BOS,0,2,37430,189,2,W
2010-06-29,0,BOS,5,8,38013,210,3,W
2010-06-30,0,BOS,9,4,38055,215,-5,NW
2010-07-02,0,BOS,2,3,38067,127,1,W
2010-07-03,0,BOS,3,9,38106,176,6,W
2010-07-04,0,BOS,6,1,37742,168,-5,NW
2010-07-15,0,BOS,7,2,38062,191,-5,NW
2010-07-16,0,BOS,8,4,37669,201,-4,NW
2010-07-17,0,BOS,2,3,37744,178,1,W
2010-07-18,0,BOS,4,2,37431,177,-2,NW
2010-07-30,0,BOS,6,5,37832,229,-1,NW
2010-07-31,0,BOS,4,5,37498,209,1,W
2010-08-01,0,BOS,3,4,37479,168,1,W
2010-08-02,0,BOS,6,5,37931,198,-1,NW
2010-08-03,0,BOS,1,3,37714,161,2,W
2010-08-04,0,BOS,9,1,37902,187,-8,NW
2010-08-05,0,BOS,2,6,38102,180,4,W
2010-08-17,0,BOS,0,6,38304,163,6,W
2010-08-18,0,BOS,5,7,37779,191,2,W
2010-08-19,0,BOS,7,2,37641,186,-5,NW
2010-08-20,0,BOS,16,2,37726,182,-14,NW
2010-08-21,0,BOS,4,5,37614,203,1,W
2010-08-22,0,BOS,0,5,37506,165,5,W
2010-08-23,0,BOS,3,6,37133,141,3,W
2010-08-25,1,BOS,3,5,37183,164,2,W
2010-08-25,2,BOS,4,2,37451,161,-2,NW
2010-09-04,1,BOS,3,1,37411,173,-2,NW
2010-09-04,2,BOS,3,1,37858,183,-2,NW
2010-09-05,0,BOS,7,5,37570,245,-2,NW
2010-09-06,0,BOS,5,12,37546,209,7,W
2010-09-07,0,BOS,14,5,37290,196,-9,NW
2010-09-08,0,BOS,5,11,37757,197,6,W
2010-09-17,0,BOS,11,9,37679,197,-2,NW
2010-09-18,0,BOS,4,3,37863,196,-1,NW
2010-09-19,0,BOS,0,6,37234,157,6,W
2010-09-20,0,BOS,4,2,37560,192,-2,NW
2010-09-21,0,BOS,9,1,37464,208,-8,NW
2010-09-22,0,BOS,1,6,37729,164,5,W
2010-10-02,1,BOS,6,5,37467,258,-1,NW
2010-10-02,2,BOS,6,7,37589,240,1,W
2010-10-03,0,BOS,4,8,37453,189,4,W
2011-04-08,0,BOS,6,9,37178,186,3,W
2011-04-09,0,BOS,9,4,37488,206,-5,NW
2011-04-10,0,BOS,0,4,37861,178,4,W
2011-04-11,0,BOS,16,5,37568,209,-11,NW
2011-04-12,0,BOS,3,2,37015,174,-1,NW
2011-04-15,0,BOS,7,6,37467,227,-1,NW
2011-04-16,0,BOS,1,4,37310,192,3,W
2011-04-17,0,BOS,1,8,37802,183,7,W
2011-04-18,0,BOS,1,9,37916,169,8,W
2011-04-29,0,BOS,5,4,37845,187,-1,NW
2011-04-30,0,BOS,2,0,37901,185,-2,NW
2011-05-01,0,BOS,2,3,37079,159,1,W
2011-05-02,0,BOS,5,9,37017,209,4,W
2011-05-03,0,BOS,3,7,37043,161,4,W
2011-05-04,0,BOS,5,3,37037,300,-2,NW
2011-05-05,0,BOS,11,0,37013,190,-11,NW
2011-05-06,0,BOS,9,2,37798,157,-7,NW
2011-05-07,0,BOS,0,4,37234,165,4,W
2011-05-08,0,BOS,5,9,37526,173,4,W
2011-05-09,0,BOS,1,2,37276,235,1,W
2011-05-16,0,BOS,7,8,37138,233,1,W
2011-05-18,0,BOS,0,1,37311,182,1,W
2011-05-19,0,BOS,3,4,37660,188,1,W
2011-05-20,0,BOS,5,15,37140,215,10,W
2011-05-21,0,BOS,9,3,37798,231,-6,NW
2011-05-22,0,BOS,1,5,37688,164,4,W
2011-05-30,0,BOS,7,3,37463,204,-4,NW
2011-05-31,0,BOS,10,7,37269,171,-3,NW
2011-06-01,0,BOS,7,4,37321,173,-3,NW
2011-06-03,0,BOS,6,8,37808,215,2,W
2011-06-04,0,BOS,8,9,37485,317,1,W
2011-06-05,0,BOS,3,6,37796,170,3,W
2011-06-17,0,BOS,4,10,37833,186,6,W
2011-06-18,0,BOS,4,2,38175,168,-2,NW
2011-06-19,0,BOS,3,12,37903,157,9,W
2011-06-20,0,BOS,5,14,38020,220,9,W
2011-06-21,0,BOS,5,4,38422,222,-1,NW
2011-06-22,0,BOS,5,1,37419,169,-4,NW
2011-07-04,0,BOS,9,7,38072,217,-2,NW
2011-07-05,0,BOS,2,3,37745,158,1,W
2011-07-06,0,BOS,4,6,37404,159,2,W
2011-07-07,0,BOS,4,10,37981,185,6,W
2011-07-08,0,BOS,3,10,37729,196,7,W
2011-07-09,0,BOS,0,4,38205,168,4,W
2011-07-10,0,BOS,6,8,37688,206,2,W
2011-07-22,0,BOS,4,7,38048,173,3,W
2011-07-23,0,BOS,1,3,38115,195,2,W
2011-07-24,0,BOS,8,12,37650,181,4,W
2011-07-25,0,BOS,3,1,37727,268,-2,NW
2011-07-26,0,BOS,9,13,37460,232,4,W
2011-07-27,0,BOS,5,12,38329,188,7,W
2011-07-28,0,BOS,4,3,37822,171,-1,NW
2011-08-01,0,BOS,9,6,37943,191,-3,NW
2011-08-02,0,BOS,2,3,38101,188,1,W
2011-08-03,0,BOS,3,4,38172,181,1,W
2011-08-04,0,BOS,7,3,38477,202,-4,NW
2011-08-05,0,BOS,3,2,38006,206,-1,NW
2011-08-06,0,BOS,4,10,37416,205,6,W
2011-08-07,0,BOS,2,3,38189,255,1,W
2011-08-16,1,BOS,1,3,38525,144,2,W
2011-08-16,2,BOS,6,2,38278,182,-4,NW
2011-08-17,0,BOS,4,0,37747,180,-4,NW
2011-08-26,0,BOS,15,5,38239,216,-10,NW
2011-08-27,1,BOS,3,9,37314,186,6,W
2011-08-27,2,BOS,0,4,37039,186,4,W
2011-08-30,0,BOS,5,2,37773,239,-3,NW
2011-08-31,0,BOS,5,9,38021,196,4,W
2011-09-01,0,BOS,4,2,38074,261,-2,NW
2011-09-02,0,BOS,10,0,38083,168,-10,NW
2011-09-03,0,BOS,7,12,37806,224,5,W
2011-09-04,0,BOS,11,4,37744,208,-7,NW
2011-09-13,0,BOS,6,18,38020,187,12,W
2011-09-14,0,BOS,5,4,37087,177,-1,NW
2011-09-15,0,BOS,9,2,38071,205,-7,NW
2011-09-16,0,BOS,3,4,38019,212,1,W
2011-09-17,0,BOS,4,3,37682,192,-1,NW
2011-09-18,0,BOS,8,5,37613,233,-3,NW
2011-09-19,1,BOS,6,5,37885,170,-1,NW
2011-09-19,2,BOS,9,18,37261,235,9,W
2011-09-20,0,BOS,7,5,37414,216,-2,NW
2011-09-21,0,BOS,6,4,38004,179,-2,NW
2012-04-13,0,BOS,2,12,37032,199,10,W
2012-04-14,0,BOS,5,13,38024,198,8,W
2012-04-15,0,BOS,4,6,38024,192,2,W
2012-04-16,0,BOS,1,0,38108,188,-1,NW
2012-04-17,0,BOS,18,3,38229,205,-15,NW
2012-04-18,0,BOS,6,3,37967,183,-3,NW
2012-04-20,0,BOS,6,2,36770,198,-4,NW
2012-04-21,0,BOS,15,9,37839,232,-6,NW
2012-04-30,0,BOS,6,11,37359,203,5,W
2012-05-01,0,BOS,5,3,37225,211,-2,NW
2012-05-02,0,BOS,4,2,37434,202,-2,NW
2012-05-04,0,BOS,6,4,37223,277,-2,NW
2012-05-05,0,BOS,8,2,37581,176,-6,NW
2012-05-06,0,BOS,9,6,37394,367,-3,NW
2012-05-10,0,BOS,8,3,37348,191,-5,NW
2012-05-11,0,BOS,5,7,37438,237,2,W
2012-05-12,0,BOS,1,4,38048,150,3,W
2012-05-13,0,BOS,1,12,37611,157,11,W
2012-05-14,0,BOS,1,6,37334,145,5,W
2012-05-15,0,BOS,0,5,37292,173,5,W
2012-05-25,0,BOS,7,4,37594,205,-3,NW
2012-05-26,0,BOS,2,3,38099,180,1,W
2012-05-27,0,BOS,4,3,37844,202,-1,NW
2012-05-28,0,BOS,4,7,37921,157,3,W
2012-05-29,0,BOS,3,6,37216,195,3,W
2012-05-30,0,BOS,4,6,37195,184,2,W
2012-05-31,0,BOS,7,3,37629,203,-4,NW
2012-06-05,0,BOS,8,6,37181,214,-2,NW
2012-06-06,0,BOS,2,1,37243,151,-1,NW
2012-06-07,0,BOS,0,7,37307,170,7,W
2012-06-08,0,BOS,7,4,37309,193,-3,NW
2012-06-09,0,BOS,4,2,37534,173,-2,NW
2012-06-10,0,BOS,4,3,37467,186,-1,NW
2012-06-19,0,BOS,5,7,37701,173,2,W
2012-06-20,0,BOS,5,15,37362,194,10,W
2012-06-21,0,BOS,5,6,37261,189,1,W
2012-06-22,0,BOS,4,1,37281,175,-3,NW
2012-06-23,0,BOS,4,8,37782,183,4,W
2012-06-24,0,BOS,4,9,37565,175,5,W
2012-06-25,0,BOS,9,6,37208,181,-3,NW
2012-06-26,0,BOS,1,5,37755,182,4,W
2012-06-27,0,BOS,4,10,37744,160,6,W
2012-07-06,0,BOS,10,8,38066,239,-2,NW
2012-07-07,1,BOS,6,1,38170,187,-5,NW
2012-07-07,2,BOS,5,9,37791,216,4,W
2012-07-08,0,BOS,7,3,38270,242,-4,NW
2012-07-16,0,BOS,1,5,38334,160,4,W
2012-07-17,0,BOS,7,5,37771,186,-2,NW
2012-07-18,0,BOS,1,10,37367,170,9,W
2012-07-19,0,BOS,1,3,38413,167,2,W
2012-07-20,0,BOS,6,1,38093,181,-5,NW
2012-07-21,0,BOS,7,3,38170,184,-4,NW
2012-07-22,0,BOS,15,7,37737,208,-8,NW
2012-07-30,0,BOS,3,7,37784,176,4,W
2012-07-31,0,BOS,1,4,37275,142,3,W
2012-08-01,0,BOS,7,5,37213,214,-2,NW
2012-08-02,0,BOS,5,0,37191,155,-5,NW
2012-08-03,0,BOS,6,5,37285,248,-1,NW
2012-08-04,0,BOS,6,4,37914,202,-2,NW
2012-08-05,0,BOS,4,6,37019,194,2,W
2012-08-06,0,BOS,2,9,37316,167,7,W
2012-08-07,0,BOS,6,3,38416,201,-3,NW
2012-08-08,0,BOS,10,9,37716,210,-1,NW
2012-08-21,0,BOS,5,3,37794,180,-2,NW
2012-08-22,0,BOS,7,3,37373,194,-4,NW
2012-08-23,0,BOS,14,13,37829,274,-1,NW
2012-08-24,0,BOS,3,4,37228,174,1,W
2012-08-25,0,BOS,10,9,37103,271,-1,NW
2012-08-26,0,BOS,6,8,37188,216,2,W
2012-08-27,0,BOS,1,5,37506,154,4,W
2012-09-07,0,BOS,7,5,37156,188,-2,NW
2012-09-08,0,BOS,9,2,37107,175,-7,NW
2012-09-09,0,BOS,4,3,37226,183,-1,NW
2012-09-11,0,BOS,3,4,37437,191,1,W
2012-09-12,0,BOS,5,4,37230,223,-1,NW
2012-09-13,0,BOS,2,0,38134,191,-2,NW
2012-09-21,0,BOS,4,2,37731,180,-2,NW
2012-09-22,0,BOS,9,6,37570,254,-3,NW
2012-09-23,0,BOS,1,2,37310,173,1,W
2012-09-25,0,BOS,5,2,37045,170,-3,NW
2012-09-26,0,BOS,4,2,37247,198,-2,NW
2013-04-08,0,BOS,1,3,37008,162,2,W
2013-04-10,0,BOS,8,5,30862,173,-3,NW
2013-04-11,0,BOS,3,2,27704,195,-1,NW
2013-04-13,0,BOS,1,2,33039,203,1,W
2013-04-14,0,BOS,0,5,35198,169,5,W
2013-04-15,0,BOS,2,3,37449,183,1,W
2013-04-20,0,BOS,3,4,35152,178,1,W
2013-04-21,1,BOS,4,2,31483,174,-2,NW
2013-04-21,2,BOS,5,4,33270,191,-1,NW
2013-04-22,0,BOS,6,9,28926,209,3,W
2013-04-23,0,BOS,13,0,29006,153,-13,NW
2013-04-24,0,BOS,5,6,29274,220,1,W
2013-04-25,0,BOS,2,7,30093,179,5,W
2013-04-26,0,BOS,3,7,29312,229,4,W
2013-04-27,0,BOS,4,8,34726,220,4,W
2013-04-28,0,BOS,1,6,36527,176,5,W
2013-05-06,0,BOS,5,6,31088,284,1,W
2013-05-07,0,BOS,6,1,30549,181,-5,NW
2013-05-08,0,BOS,15,8,29969,222,-7,NW
2013-05-09,0,BOS,5,3,31571,184,-2,NW
2013-05-10,0,BOS,0,5,33606,166,5,W
2013-05-11,0,BOS,3,2,36543,162,-1,NW
2013-05-12,0,BOS,12,4,35532,193,-8,NW
2013-05-23,0,BOS,12,3,35254,214,-9,NW
2013-05-24,0,BOS,1,8,34074,175,7,W
2013-05-25,0,BOS,4,7,36504,204,3,W
2013-05-26,0,BOS,5,6,37046,199,1,W
2013-05-27,0,BOS,3,9,33627,206,6,W
2013-05-28,0,BOS,3,1,33463,150,-2,NW
2013-06-04,0,BOS,5,17,32035,190,12,W
2013-06-05,0,BOS,3,2,33296,197,-1,NW
2013-06-06,0,BOS,3,6,35352,201,3,W
2013-06-08,1,BOS,9,5,34499,240,-4,NW
2013-06-08,2,BOS,2,7,36518,205,5,W
2013-06-09,0,BOS,5,10,37054,213,5,W
2013-06-18,1,BOS,1,5,33430,190,4,W
2013-06-18,2,BOS,1,3,32156,147,2,W
2013-06-19,0,BOS,6,2,35710,201,-4,NW
2013-06-25,0,BOS,4,11,36286,220,7,W
2013-06-26,0,BOS,3,5,34632,156,2,W
2013-06-27,0,BOS,4,7,34750,154,3,W
2013-06-28,0,BOS,5,7,36383,202,2,W
2013-06-29,0,BOS,6,2,37437,185,-4,NW
2013-06-30,0,BOS,4,5,37425,190,1,W
2013-07-02,0,BOS,1,4,36498,168,3,W
2013-07-03,0,BOS,1,2,36911,185,1,W
2013-07-04,0,BOS,2,8,37607,201,6,W
2013-07-19,0,BOS,2,4,38130,175,2,W
2013-07-20,0,BOS,5,2,37601,192,-3,NW
2013-07-21,0,BOS,7,8,38138,286,1,W
2013-07-22,0,BOS,3,0,35016,172,-3,NW
2013-07-23,0,BOS,2,6,34609,186,4,W
2013-07-24,0,BOS,5,1,36514,180,-4,NW
2013-07-29,0,BOS,2,1,37242,201,-1,NW
2013-07-30,0,BOS,2,8,34578,164,6,W
2013-07-31,0,BOS,4,5,35059,303,1,W
2013-08-01,0,BOS,7,8,35886,197,1,W
2013-08-02,0,BOS,7,6,37652,212,-1,NW
2013-08-03,0,BOS,2,5,37941,182,3,W
2013-08-04,0,BOS,0,4,37611,196,4,W
2013-08-16,0,BOS,10,3,38143,211,-7,NW
2013-08-17,0,BOS,1,6,37517,206,5,W
2013-08-18,0,BOS,9,6,37917,252,-3,NW
2013-08-27,0,BOS,2,13,36226,179,11,W
2013-08-28,0,BOS,3,4,31962,180,1,W
2013-08-29,0,BOS,3,2,33300,200,-1,NW
2013-08-30,0,BOS,3,4,36063,189,1,W
2013-08-31,0,BOS,2,7,37363,191,5,W
2013-09-01,0,BOS,6,7,37053,219,1,W
2013-09-02,0,BOS,3,0,36188,179,-3,NW
2013-09-03,0,BOS,1,2,32071,176,1,W
2013-09-04,0,BOS,4,20,33720,213,16,W
2013-09-13,0,BOS,4,8,37542,186,4,W
2013-09-14,0,BOS,1,5,37510,163,4,W
2013-09-15,0,BOS,2,9,37137,193,7,W
2013-09-17,0,BOS,3,2,35030,188,-1,NW
2013-09-18,0,BOS,5,3,38540,241,-2,NW
2013-09-19,0,BOS,1,3,36436,138,2,W
2013-09-20,0,BOS,3,6,37215,206,3,W
2013-09-21,0,BOS,4,2,37569,187,-2,NW
2013-09-22,0,BOS,2,5,37020,133,3,W
2014-04-04,0,BOS,6,2,36728,199,-4,NW
2014-04-05,0,BOS,7,6,35729,263,-1,NW
2014-04-06,0,BOS,4,0,35958,177,-4,NW
2014-04-07,0,BOS,1,5,35842,187,4,W
2014-04-08,0,BOS,10,7,34142,191,-3,NW
2014-04-09,0,BOS,2,4,33585,177,2,W
2014-04-18,0,BOS,8,4,36408,206,-4,NW
2014-04-19,0,BOS,2,4,37689,167,2,W
2014-04-20,0,BOS,5,6,33947,202,1,W
2014-04-21,0,BOS,7,6,37513,198,-1,NW
2014-04-22,0,BOS,9,3,37041,197,-6,NW
2014-04-23,0,BOS,1,5,37015,192,4,W
2014-04-24,0,BOS,14,5,37356,231,-9,NW
2014-04-29,0,BOS,4,7,34794,220,3,W
2014-05-01,1,BOS,2,1,35621,207,-1,NW
2014-05-01,2,BOS,6,5,33465,224,-1,NW
2014-05-02,0,BOS,1,7,34850,217,6,W
2014-05-03,0,BOS,3,6,37042,164,3,W
2014-05-04,0,BOS,3,2,35649,225,-1,NW
2014-05-06,0,BOS,3,4,36004,244,1,W
2014-05-07,0,BOS,3,4,37072,167,1,W
2014-05-16,0,BOS,1,0,37225,194,-1,NW
2014-05-17,0,BOS,6,1,37608,169,-5,NW
2014-05-18,0,BOS,6,2,35006,199,-4,NW
2014-05-20,0,BOS,7,4,37904,197,-3,NW
2014-05-21,0,BOS,6,4,36116,203,-2,NW
2014-05-22,0,BOS,7,2,36018,178,-5,NW
2014-05-28,0,BOS,0,4,36189,189,4,W
2014-05-29,0,BOS,3,4,36292,180,1,W
2014-05-30,0,BOS,2,3,35820,235,1,W
2014-05-31,0,BOS,1,7,37076,187,6,W
2014-06-01,0,BOS,0,4,37688,192,4,W
2014-06-12,0,BOS,2,5,37750,188,3,W
2014-06-13,0,BOS,3,10,35772,193,7,W
2014-06-14,0,BOS,3,2,37181,204,-1,NW
2014-06-15,0,BOS,3,2,37356,243,-1,NW
2014-06-16,0,BOS,0,1,35693,165,1,W
2014-06-17,0,BOS,1,2,36835,168,1,W
2014-06-18,0,BOS,1,2,36489,151,1,W
2014-06-30,0,BOS,2,0,37814,179,-2,NW
2014-07-01,0,BOS,2,1,36748,215,-1,NW
2014-07-02,0,BOS,16,9,37055,259,-7,NW
2014-07-05,1,BOS,2,3,35714,160,1,W
2014-07-05,2,BOS,7,4,36468,216,-3,NW
2014-07-06,0,BOS,7,6,35811,305,-1,NW
2014-07-07,0,BOS,4,0,35114,175,-4,NW
2014-07-08,0,BOS,8,3,35345,191,-5,NW
2014-07-09,0,BOS,4,5,36218,174,1,W
2014-07-10,0,BOS,3,4,37547,202,1,W
2014-07-18,0,BOS,4,5,37743,211,1,W
2014-07-19,0,BOS,1,2,37878,159,1,W
2014-07-20,0,BOS,0,6,37439,176,6,W
2014-07-28,0,BOS,14,1,37974,195,-13,NW
2014-07-29,0,BOS,4,2,38275,183,-2,NW
2014-07-30,0,BOS,6,1,38203,168,-5,NW
2014-08-01,0,BOS,3,4,37782,183,1,W
2014-08-02,0,BOS,6,4,37302,236,-2,NW
2014-08-03,0,BOS,8,7,38035,222,-1,NW
2014-08-14,0,BOS,4,9,38065,199,5,W
2014-08-15,0,BOS,5,3,37016,226,-2,NW
2014-08-16,0,BOS,7,10,37652,230,3,W
2014-08-17,0,BOS,8,1,36717,191,-7,NW
2014-08-18,0,BOS,4,2,35170,202,-2,NW
2014-08-19,0,BOS,4,3,35471,204,-1,NW
2014-08-20,0,BOS,8,3,35136,222,-5,NW
2014-08-21,0,BOS,2,0,36160,190,-2,NW
2014-08-22,0,BOS,5,3,36433,221,-2,NW
2014-08-23,0,BOS,7,3,36905,208,-4,NW
2014-08-24,0,BOS,8,6,37022,247,-2,NW
2014-09-05,0,BOS,8,9,35667,233,1,W
2014-09-06,0,BOS,3,4,36677,203,1,W
2014-09-07,0,BOS,3,1,36261,164,-2,NW
2014-09-08,0,BOS,4,0,35894,188,-4,NW
2014-09-09,0,BOS,4,1,37008,212,-3,NW
2014-09-10,0,BOS,10,6,35374,203,-4,NW
2014-09-23,0,BOS,6,2,35566,194,-4,NW
2014-09-24,0,BOS,3,11,35741,220,8,W
2014-09-25,0,BOS,1,11,36590,196,10,W
2014-09-26,0,BOS,3,2,37605,181,-1,NW
2014-09-27,0,BOS,4,10,37147,184,6,W
2014-09-28,0,BOS,9,5,36879,194,-4,NW
2015-04-13,0,BOS,4,9,37203,181,5,W
2015-04-14,0,BOS,7,8,35258,203,1,W
2015-04-15,0,BOS,10,5,33493,188,-5,NW
2015-04-17,0,BOS,2,3,34341,193,1,W
2015-04-18,0,BOS,4,1,37655,204,-3,NW
2015-04-19,0,BOS,8,3,37761,194,-5,NW
2015-04-20,0,BOS,1,7,36829,141,6,W
2015-04-27,0,BOS,5,6,34739,168,1,W
2015-04-28,0,BOS,11,8,33920,241,-3,NW
2015-04-29,0,BOS,1,4,34220,163,3,W
2015-05-01,0,BOS,3,2,35444,194,-1,NW
2015-05-02,0,BOS,4,2,36611,164,-2,NW
2015-05-03,0,BOS,8,5,33198,232,-3,NW
2015-05-04,0,BOS,5,1,34541,190,-4,NW
2015-05-05,0,BOS,0,2,33688,146,2,W
2015-05-06,0,BOS,5,3,35060,202,-2,NW
2015-05-19,0,BOS,3,4,36580,170,1,W
2015-05-20,0,BOS,2,1,35726,193,-1,NW
2015-05-21,0,BOS,3,1,34945,169,-2,NW
2015-05-22,0,BOS,12,5,36150,215,-7,NW
2015-05-23,0,BOS,3,8,37735,189,5,W
2015-05-24,0,BOS,1,6,37742,157,5,W
2015-06-02,0,BOS,0,1,32622,141,1,W
2015-06-03,1,BOS,3,6,31704,153,3,W
2015-06-03,2,BOS,2,0,33291,135,-2,NW
2015-06-04,0,BOS,8,4,33615,192,-4,NW
2015-06-05,0,BOS,2,4,34910,151,2,W
2015-06-06,0,BOS,2,4,36713,190,2,W
2015-06-07,0,BOS,4,7,36913,191,3,W
2015-06-12,0,BOS,13,10,37575,204,-3,NW
2015-06-13,0,BOS,5,4,37158,206,-1,NW
2015-06-14,0,BOS,13,5,36296,192,-8,NW
2015-06-15,0,BOS,4,2,34439,174,-2,NW
2015-06-16,0,BOS,4,9,35662,158,5,W
2015-06-23,0,BOS,6,4,36508,188,-2,NW
2015-06-24,0,BOS,1,5,37762,158,4,W
2015-06-25,0,BOS,8,6,37706,186,-2,NW
2015-07-03,0,BOS,12,8,37837,263,-4,NW
2015-07-04,0,BOS,1,6,36703,182,5,W
2015-07-05,0,BOS,4,5,36481,241,1,W
2015-07-07,0,BOS,3,4,36863,164,1,W
2015-07-08,0,BOS,3,6,37009,161,3,W
2015-07-10,0,BOS,5,1,37984,183,-4,NW
2015-07-11,0,BOS,3,5,38047,190,2,W
2015-07-12,0,BOS,8,6,37283,216,-2,NW
2015-07-24,0,BOS,1,2,37650,222,1,W
2015-07-25,0,BOS,5,1,37256,177,-4,NW
2015-07-26,0,BOS,1,11,35582,194,10,W
2015-07-27,0,BOS,10,8,37401,234,-2,NW
2015-07-28,0,BOS,9,4,38063,159,-5,NW
2015-07-29,0,BOS,9,2,37104,222,-7,NW
2015-07-30,0,BOS,2,8,36215,160,6,W
2015-07-31,0,BOS,5,7,36715,193,2,W
2015-08-01,0,BOS,7,11,35944,219,4,W
2015-08-02,0,BOS,4,3,35699,190,-1,NW
2015-08-14,0,BOS,1,15,37678,210,14,W
2015-08-15,0,BOS,10,22,36027,201,12,W
2015-08-16,0,BOS,10,8,35260,264,-2,NW
2015-08-17,0,BOS,8,2,32701,192,-6,NW
2015-08-18,0,BOS,1,9,31907,176,8,W
2015-08-19,0,BOS,4,6,32465,189,2,W
2015-08-20,0,BOS,1,4,35458,169,3,W
2015-08-21,0,BOS,2,7,35203,151,5,W
2015-08-22,0,BOS,6,3,37135,209,-3,NW
2015-08-23,0,BOS,8,6,36151,220,-2,NW
2015-08-31,0,BOS,3,4,36148,224,1,W
2015-09-01,0,BOS,3,1,35077,161,-2,NW
2015-09-02,0,BOS,13,8,34416,213,-5,NW
2015-09-04,0,BOS,5,7,33674,202,2,W
2015-09-05,0,BOS,2,9,36534,144,7,W
2015-09-06,0,BOS,2,6,34708,177,4,W
2015-09-07,0,BOS,4,11,33659,168,7,W
2015-09-08,0,BOS,5,1,33432,203,-4,NW
2015-09-09,0,BOS,4,10,34464,211,6,W
2015-09-21,0,BOS,7,8,33673,227,1,W
2015-09-22,0,BOS,5,2,33673,163,-3,NW
2015-09-23,0,BOS,6,2,32753,210,-4,NW
2015-09-24,0,BOS,4,2,34916,159,-2,NW
2015-09-25,0,BOS,0,7,32411,162,7,W
2015-09-26,0,BOS,0,8,36316,176,8,W
2015-09-27,0,BOS,0,2,33306,148,2,W
2016-04-11,0,BOS,9,7,37160,206,-2,NW
2016-04-12,0,BOS,9,5,31114,203,-4,NW
2016-04-13,0,BOS,2,4,31011,193,2,W
2016-04-15,0,BOS,3,5,31415,182,2,W
2016-04-16,0,BOS,2,4,36267,163,2,W
2016-04-17,0,BOS,5,3,37217,189,-2,NW
2016-04-18,0,BOS,4,3,37168,192,-1,NW
2016-04-19,0,BOS,3,0,32061,205,-3,NW
2016-04-20,0,BOS,3,7,31689,182,4,W
2016-04-21,0,BOS,12,8,37954,256,-4,NW
2016-04-27,0,BOS,4,9,33380,182,5,W
2016-04-28,0,BOS,5,3,32232,202,-2,NW
2016-04-29,0,BOS,2,4,37115,170,2,W
2016-04-30,0,BOS,0,8,37901,210,8,W
2016-05-01,0,BOS,7,8,34279,197,1,W
2016-05-09,0,BOS,7,14,35227,226,7,W
2016-05-10,0,BOS,5,13,32167,187,8,W
2016-05-11,0,BOS,3,13,33283,197,10,W
2016-05-12,0,BOS,1,11,34982,176,10,W
2016-05-13,0,BOS,7,6,33148,229,-1,NW
2016-05-14,0,BOS,5,6,37430,253,1,W
2016-05-15,0,BOS,9,10,35736,220,1,W
2016-05-20,0,BOS,4,2,37354,187,-2,NW
2016-05-21,0,BOS,1,9,37254,197,8,W
2016-05-22,0,BOS,2,5,36021,203,3,W
2016-05-24,0,BOS,3,8,36123,175,5,W
2016-05-25,0,BOS,3,10,36430,189,7,W
2016-05-26,0,BOS,8,2,36162,171,-6,NW
2016-06-03,0,BOS,5,2,37129,190,-3,NW
2016-06-04,0,BOS,4,6,37762,188,2,W
2016-06-05,0,BOS,5,4,35823,164,-1,NW
2016-06-14,0,BOS,3,2,38009,167,-1,NW
2016-06-15,0,BOS,4,6,36233,178,2,W
2016-06-16,0,BOS,5,1,36757,173,-4,NW
2016-06-17,0,BOS,8,4,35896,169,-4,NW
2016-06-18,0,BOS,2,6,37195,173,4,W
2016-06-19,0,BOS,1,2,37211,185,1,W
2016-06-20,0,BOS,3,1,36291,213,-2,NW
2016-06-21,0,BOS,3,1,36544,174,-2,NW
2016-06-22,0,BOS,8,6,37413,218,-2,NW
2016-06-23,0,BOS,7,8,37790,265,1,W
2016-07-01,0,BOS,4,5,37117,216,1,W
2016-07-02,0,BOS,21,2,36552,218,-19,NW
2016-07-03,0,BOS,5,10,36801,232,5,W
2016-07-04,0,BOS,5,12,36253,220,7,W
2016-07-05,0,BOS,7,2,35964,201,-5,NW
2016-07-06,0,BOS,6,11,37175,199,5,W
2016-07-08,0,BOS,5,6,37739,200,1,W
2016-07-09,0,BOS,1,4,36900,163,3,W
2016-07-10,0,BOS,0,4,36669,151,4,W
2016-07-19,0,BOS,0,4,38082,162,4,W
2016-07-20,0,BOS,7,11,38201,226,4,W
2016-07-21,0,BOS,2,13,37566,165,11,W
2016-07-22,0,BOS,2,1,37001,180,-1,NW
2016-07-23,0,BOS,11,9,37600,251,-2,NW
2016-07-24,0,BOS,7,8,36806,195,1,W
2016-07-25,0,BOS,4,2,37479,207,-2,NW
2016-07-26,0,BOS,9,8,38378,213,-1,NW
2016-07-27,0,BOS,4,3,37842,175,-1,NW
2016-08-09,0,BOS,3,5,38089,193,2,W
2016-08-10,0,BOS,9,4,37779,255,-5,NW
2016-08-11,0,BOS,4,2,38161,182,-2,NW
2016-08-12,0,BOS,4,9,37555,173,5,W
2016-08-13,0,BOS,3,6,37653,192,3,W
2016-08-14,0,BOS,2,16,36842,169,14,W
2016-08-26,0,BOS,6,3,38134,194,-3,NW
2016-08-27,0,BOS,3,8,37933,183,5,W
2016-08-28,0,BOS,10,4,37337,205,-6,NW
2016-08-29,0,BOS,4,9,36948,191,5,W
2016-08-30,0,BOS,4,3,37083,191,-1,NW
2016-08-31,0,BOS,6,8,36786,190,2,W
2016-09-12,0,BOS,2,12,37551,160,10,W
2016-09-13,0,BOS,6,3,38041,209,-3,NW
2016-09-14,0,BOS,1,0,37973,155,-1,NW
2016-09-15,0,BOS,5,7,37767,232,2,W
2016-09-16,0,BOS,4,7,37927,193,3,W
2016-09-17,0,BOS,5,6,37267,216,1,W
2016-09-18,0,BOS,4,5,37306,211,1,W
2016-09-30,0,BOS,3,5,37661,205,2,W
2016-10-01,0,BOS,4,3,37396,209,-1,NW
2016-10-02,0,BOS,2,1,36787,194,-1,NW
2017-04-03,0,BOS,3,5,36594,183,2,W
2017-04-05,0,BOS,0,3,36137,233,3,W
2017-04-11,0,BOS,1,8,37497,195,7,W
2017-04-12,0,BOS,12,5,32211,226,-7,NW
2017-04-13,0,BOS,3,4,32400,195,1,W
2017-04-14,0,BOS,10,5,36813,217,-5,NW
2017-04-15,0,BOS,1,2,36686,174,1,W
2017-04-16,0,BOS,5,7,36209,226,2,W
2017-04-17,0,BOS,3,4,37318,187,1,W
2017-04-26,0,BOS,3,1,32072,196,-2,NW
2017-04-27,0,BOS,3,0,34054,141,-3,NW
2017-04-28,0,BOS,4,5,37054,208,1,W
2017-04-29,0,BOS,7,4,36776,180,-3,NW
2017-04-30,0,BOS,2,6,36916,208,4,W
2017-05-01,0,BOS,5,2,33489,190,-3,NW
2017-05-02,0,BOS,2,5,32932,153,3,W
2017-05-03,0,BOS,2,4,33162,204,2,W
2017-05-04,0,BOS,8,3,36563,201,-5,NW
2017-05-12,0,BOS,5,4,36496,204,-1,NW
2017-05-13,0,BOS,3,6,35447,174,3,W
2017-05-14,0,BOS,11,2,35080,272,-9,NW
2017-05-23,0,BOS,6,11,34769,203,5,W
2017-05-24,0,BOS,4,9,36089,179,5,W
2017-05-25,0,BOS,2,6,33484,203,4,W
2017-05-26,0,BOS,0,3,35080,191,3,W
2017-05-27,0,BOS,0,6,36985,143,6,W
2017-05-28,0,BOS,5,0,37174,194,-5,NW
2017-06-09,0,BOS,3,5,36853,216,2,W
2017-06-10,0,BOS,3,11,37162,219,8,W
2017-06-11,0,BOS,8,3,35457,246,-5,NW
2017-06-12,0,BOS,5,6,36757,256,1,W
2017-06-13,0,BOS,3,4,37141,264,1,W
2017-06-23,0,BOS,4,9,37034,187,5,W
2017-06-24,0,BOS,6,3,36868,214,-3,NW
2017-06-25,0,BOS,4,2,36474,170,-2,NW
2017-06-26,0,BOS,1,4,37172,175,3,W
2017-06-27,0,BOS,2,9,36804,198,7,W
2017-06-28,0,BOS,4,1,37487,194,-3,NW
2017-06-29,0,BOS,3,6,37445,204,3,W
2017-07-14,0,BOS,4,5,37570,207,1,W
2017-07-15,0,BOS,4,1,36936,350,-3,NW
2017-07-16,1,BOS,3,0,37343,193,-3,NW
2017-07-16,2,BOS,0,3,36719,179,3,W
2017-07-17,0,BOS,4,3,36144,198,-1,NW
2017-07-18,0,BOS,4,5,36488,299,1,W
2017-07-19,0,BOS,1,5,37360,167,4,W
2017-07-20,0,BOS,8,6,37094,205,-2,NW
2017-07-28,0,BOS,4,2,37321,164,-2,NW
2017-07-29,0,BOS,8,9,36912,285,1,W
2017-07-30,0,BOS,5,3,36480,193,-2,NW
2017-07-31,0,BOS,2,6,37169,167,4,W
2017-08-01,0,BOS,10,12,37126,216,2,W
2017-08-03,0,BOS,5,9,37442,206,4,W
2017-08-04,0,BOS,2,3,36612,223,1,W
2017-08-05,0,BOS,1,4,36599,161,3,W
2017-08-06,0,BOS,3,6,37283,156,3,W
2017-08-14,0,BOS,7,3,37430,194,-4,NW
2017-08-15,0,BOS,4,10,37345,172,6,W
2017-08-16,0,BOS,4,5,37181,215,1,W
2017-08-18,0,BOS,6,9,36784,249,3,W
2017-08-19,0,BOS,4,3,37274,189,-1,NW
2017-08-20,0,BOS,1,5,36911,216,4,W
2017-08-25,0,BOS,16,3,37191,217,-13,NW
2017-08-26,0,BOS,7,0,36655,178,-7,NW
2017-08-27,0,BOS,2,1,36625,202,-1,NW
2017-09-04,0,BOS,10,4,34311,205,-6,NW
2017-09-05,0,BOS,2,3,33009,360,1,W
2017-09-06,0,BOS,1,6,33190,177,5,W
2017-09-08,0,BOS,3,9,34781,194,6,W
2017-09-09,0,BOS,0,9,36734,185,9,W
2017-09-10,0,BOS,4,1,35859,202,-3,NW
2017-09-12,0,BOS,1,11,34355,186,10,W
2017-09-13,0,BOS,7,3,36366,187,-4,NW
2017-09-14,0,BOS,2,6,35470,199,4,W
2017-09-25,0,BOS,6,4,33940,177,-2,NW
2017-09-26,0,BOS,9,4,33999,184,-5,NW
2017-09-27,0,BOS,7,10,34445,177,3,W
2017-09-28,0,BOS,12,2,34222,211,-10,NW
2017-09-29,0,BOS,3,2,36623,167,-1,NW
2017-09-30,0,BOS,3,6,35722,199,3,W
2017-10-01,0,BOS,4,3,34517,189,-1,NW
2018-04-05,0,BOS,2,3,36134,235,1,W
2018-04-07,0,BOS,3,10,31821,168,7,W
2018-04-08,0,BOS,7,8,31979,230,1,W
2018-04-10,0,BOS,1,14,32357,191,13,W
2018-04-11,0,BOS,10,7,32400,239,-3,NW
2018-04-12,0,BOS,3,6,36341,181,3,W
2018-04-13,0,BOS,3,7,32610,202,4,W
2018-04-14,0,BOS,3,10,33584,185,7,W
2018-04-15,0,BOS,1,3,32489,174,2,W
2018-04-27,0,BOS,4,3,32620,190,-1,NW
2018-04-28,0,BOS,12,6,35795,232,-6,NW
2018-04-29,0,BOS,3,4,32888,181,1,W
2018-04-30,0,BOS,6,10,31314,193,4,W
2018-05-01,0,BOS,7,6,34466,265,-1,NW
2018-05-02,0,BOS,4,5,32267,165,1,W
2018-05-14,0,BOS,6,5,35249,160,-1,NW
2018-05-15,0,BOS,5,3,34906,196,-2,NW
2018-05-16,0,BOS,4,6,34947,188,2,W
2018-05-17,0,BOS,2,6,36615,164,4,W
2018-05-18,0,BOS,7,4,34935,198,-3,NW
2018-05-19,0,BOS,3,6,34195,174,3,W
2018-05-20,0,BOS,0,5,35550,205,5,W
2018-05-25,0,BOS,2,6,37008,193,4,W
2018-05-26,0,BOS,6,8,36510,209,2,W
2018-05-27,0,BOS,7,1,36543,173,-6,NW
2018-05-28,0,BOS,3,8,34700,174,5,W
2018-05-29,0,BOS,3,8,33380,179,5,W
2018-05-30,0,BOS,4,6,33451,172,2,W
2018-06-05,0,BOS,0,6,34762,161,6,W
2018-06-06,0,BOS,1,7,35182,200,6,W
2018-06-07,0,BOS,7,2,36556,175,-5,NW
2018-06-08,0,BOS,1,0,36593,144,-1,NW
2018-06-09,0,BOS,2,4,36675,168,2,W
2018-06-10,0,BOS,5,2,36998,195,-3,NW
2018-06-22,0,BOS,10,14,37342,214,4,W
2018-06-23,0,BOS,7,2,36051,181,-5,NW
2018-06-24,0,BOS,0,5,36274,149,5,W
2018-06-26,0,BOS,1,9,37366,174,8,W
2018-06-27,0,BOS,6,9,37521,240,3,W
2018-06-28,0,BOS,2,4,36992,186,2,W
2018-07-09,0,BOS,0,5,36754,172,5,W
2018-07-10,0,BOS,4,8,36883,176,4,W
2018-07-11,0,BOS,2,4,36920,178,2,W
2018-07-12,0,BOS,4,6,37182,199,2,W
2018-07-13,0,BOS,13,7,37018,223,-6,NW
2018-07-14,0,BOS,2,6,36390,212,4,W
2018-07-15,0,BOS,2,5,36940,192,3,W
2018-07-26,0,BOS,2,1,37439,179,-1,NW
2018-07-27,0,BOS,3,4,37273,206,1,W
2018-07-28,0,BOS,4,10,36798,208,6,W
2018-07-29,0,BOS,0,3,36785,162,3,W
2018-07-30,0,BOS,1,2,37722,243,1,W
2018-07-31,0,BOS,3,1,37816,193,-2,NW
2018-08-02,0,BOS,7,15,37317,205,8,W
2018-08-03,0,BOS,1,4,37231,135,3,W
2018-08-04,0,BOS,1,4,36699,153,3,W
2018-08-05,0,BOS,4,5,37830,279,1,W
2018-08-17,0,BOS,3,7,37012,167,4,W
2018-08-18,0,BOS,2,5,36654,148,3,W
2018-08-19,0,BOS,2,0,37242,167,-2,NW
2018-08-20,0,BOS,5,4,37274,181,-1,NW
2018-08-21,0,BOS,6,3,37188,177,-3,NW
2018-08-22,0,BOS,4,10,37107,204,6,W
2018-08-23,0,BOS,0,7,37396,167,7,W
2018-08-28,0,BOS,7,8,36708,209,1,W
2018-08-29,0,BOS,6,14,36628,190,8,W
2018-09-07,0,BOS,6,3,36930,218,-3,NW
2018-09-08,0,BOS,5,3,36684,205,-2,NW
2018-09-09,0,BOS,5,6,32787,215,1,W
2018-09-11,0,BOS,2,7,34747,188,5,W
2018-09-12,0,BOS,0,1,35178,161,1,W
2018-09-13,0,BOS,3,4,36427,170,1,W
2018-09-14,0,BOS,8,0,37117,179,-8,NW
2018-09-15,0,BOS,3,5,36611,191,2,W
2018-09-16,0,BOS,3,4,36526,175,1,W
2018-09-24,0,BOS,2,6,35619,186,4,W
2018-09-26,1,BOS,3,19,33577,190,16,W
2018-09-26,2,BOS,10,3,34445,225,-7,NW
2018-09-28,0,BOS,11,6,36779,207,-5,NW
2018-09-29,0,BOS,8,5,36375,220,-3,NW
2018-09-30,0,BOS,2,10,36201,200,8,W
2019-04-09,0,BOS,7,5,36179,216,-2,NW
2019-04-11,0,BOS,6,7,36510,201,1,W
2019-04-12,0,BOS,4,6,33664,175,2,W
2019-04-13,0,BOS,9,5,35823,219,-4,NW
2019-04-14,0,BOS,0,4,36023,187,4,W
2019-04-15,0,BOS,8,1,35860,197,-7,NW
2019-04-23,1,BOS,7,4,30015,175,-3,NW
2019-04-23,2,BOS,4,2,30578,209,-2,NW
2019-04-24,0,BOS,4,11,31763,204,7,W
2019-04-25,0,BOS,3,7,34165,159,4,W
2019-04-27,0,BOS,2,1,34773,201,-1,NW
2019-04-28,0,BOS,5,2,33823,151,-3,NW
2019-04-29,0,BOS,4,9,30866,203,5,W
2019-04-30,0,BOS,1,5,31754,154,4,W
2019-05-01,0,BOS,3,7,33708,174,4,W
2019-05-10,0,BOS,1,14,33731,182,13,W
2019-05-11,0,BOS,5,9,36024,195,4,W
2019-05-12,0,BOS,2,11,33069,203,9,W
2019-05-14,0,BOS,5,4,35804,222,-1,NW
2019-05-15,0,BOS,5,6,37032,224,1,W
2019-05-17,0,BOS,3,1,35558,180,-2,NW
2019-05-18,0,BOS,7,3,36887,211,-4,NW
2019-05-19,0,BOS,3,4,35796,182,1,W
2019-05-27,0,BOS,5,12,37113,212,7,W
2019-05-28,0,BOS,7,5,32984,243,-2,NW
2019-05-29,0,BOS,14,9,34824,222,-5,NW
2019-06-07,0,BOS,5,1,36803,163,-4,NW
2019-06-08,1,BOS,9,2,35564,213,-7,NW
2019-06-08,2,BOS,1,5,37048,201,4,W
2019-06-09,0,BOS,6,1,34643,212,-5,NW
2019-06-10,0,BOS,4,3,34422,205,-1,NW
2019-06-11,0,BOS,9,5,35121,220,-4,NW
2019-06-12,0,BOS,3,4,34330,174,1,W
2019-06-13,0,BOS,6,7,35841,246,1,W
2019-06-21,0,BOS,5,7,36911,238,2,W
2019-06-22,0,BOS,8,7,36712,230,-1,NW
2019-06-23,0,BOS,6,1,36495,184,-5,NW
2019-06-24,0,BOS,5,6,36117,216,1,W
2019-06-25,0,BOS,3,6,34740,204,3,W
2019-06-26,0,BOS,8,7,36823,219,-1,NW
2019-06-29,0,BOS,17,13,59659,282,-4,NW
2019-06-30,0,BOS,12,8,59059,264,-4,NW
2019-07-12,0,BOS,1,8,36579,172,7,W
2019-07-13,0,BOS,11,2,36607,220,-9,NW
2019-07-14,0,BOS,7,4,36700,340,-3,NW
2019-07-15,0,BOS,8,10,35616,208,2,W
2019-07-16,0,BOS,10,4,36341,225,-6,NW
2019-07-17,0,BOS,4,5,34853,215,1,W
2019-07-18,0,BOS,0,5,35357,170,5,W
2019-07-25,0,BOS,3,19,37591,208,16,W
2019-07-26,0,BOS,5,10,37095,196,5,W
2019-07-27,0,BOS,5,9,36862,214,4,W
2019-07-28,0,BOS,9,6,37429,208,-3,NW
2019-07-30,0,BOS,6,5,36412,245,-1,NW
2019-07-31,0,BOS,8,5,33046,230,-3,NW
2019-08-01,0,BOS,9,4,37225,200,-5,NW
2019-08-05,0,BOS,5,7,33636,176,2,W
2019-08-06,0,BOS,6,2,36360,168,-4,NW
2019-08-07,0,BOS,4,5,32453,228,1,W
2019-08-08,0,BOS,0,3,34744,136,3,W
2019-08-09,0,BOS,4,16,36650,213,12,W
2019-08-10,0,BOS,12,4,36390,208,-8,NW
2019-08-11,0,BOS,5,4,36709,242,-1,NW
2019-08-16,0,BOS,1,9,37213,161,8,W
2019-08-17,0,BOS,0,4,36744,191,4,W
2019-08-18,0,BOS,7,13,36350,218,6,W
2019-08-20,0,BOS,3,2,37712,197,-1,NW
2019-08-21,0,BOS,5,2,37077,219,-3,NW
2019-09-03,0,BOS,6,5,35129,208,-1,NW
2019-09-04,0,BOS,2,6,35218,202,4,W
2019-09-05,0,BOS,2,1,32632,178,-1,NW
2019-09-06,0,BOS,1,6,36162,188,5,W
2019-09-07,0,BOS,5,1,36619,209,-4,NW
2019-09-08,0,BOS,10,5,35681,228,-5,NW
2019-09-09,0,BOS,5,0,35884,205,-5,NW
2019-09-17,0,BOS,7,6,35925,354,-1,NW
2019-09-18,0,BOS,11,3,35697,214,-8,NW
2019-09-19,0,BOS,4,5,35816,197,1,W
2019-09-27,0,BOS,4,1,34533,182,-3,NW
2019-09-28,0,BOS,9,4,36414,217,-5,NW
2019-09-29,0,BOS,4,5,35427,202,1,W
2021-04-02,0,BOS,3,0,4452,190,-3,NW
2021-04-03,0,BOS,4,2,4571,171,-2,NW
2021-04-04,0,BOS,11,3,4458,208,-8,NW
2021-04-05,0,BOS,2,11,4577,206,9,W
2021-04-06,0,BOS,5,6,4682,265,1,W
2021-04-07,0,BOS,2,9,4751,171,7,W
2021-04-17,0,BOS,4,7,4668,216,3,W
2021-04-18,1,BOS,3,2,4679,124,-1,NW
2021-04-18,2,BOS,5,1,4601,144,-4,NW
2021-04-19,0,BOS,4,11,4738,195,7,W
2021-04-20,0,BOS,2,4,4728,162,2,W
2021-04-21,0,BOS,6,3,4661,225,-3,NW
2021-04-22,0,BOS,7,3,4617,208,-4,NW
2021-04-23,0,BOS,5,6,4646,208,1,W
2021-04-24,0,BOS,8,2,4621,185,-6,NW
2021-04-25,0,BOS,3,5,4510,164,2,W
2021-05-04,0,BOS,7,11,4677,218,4,W
2021-05-05,0,BOS,6,5,4661,227,-1,NW
2021-05-06,0,BOS,9,12,4734,253,3,W
2021-05-11,0,BOS,3,2,9264,181,-1,NW
2021-05-12,0,BOS,4,1,9272,179,-3,NW
2021-05-13,0,BOS,1,8,9301,174,7,W
2021-05-14,0,BOS,3,4,9284,165,1,W
2021-05-15,0,BOS,0,9,9374,172,9,W
2021-05-16,0,BOS,6,5,9316,199,-1,NW
2021-05-25,0,BOS,3,1,9357,186,-2,NW
2021-05-26,0,BOS,5,9,9197,176,4,W
2021-05-28,0,BOS,2,5,9005,127,3,W
2021-05-29,0,BOS,1,3,25089,197,2,W
2021-06-07,0,BOS,3,5,25374,218,2,W
2021-06-08,0,BOS,7,1,23604,208,-6,NW
2021-06-09,0,BOS,8,3,21007,187,-5,NW
2021-06-10,0,BOS,8,12,23378,227,4,W
2021-06-11,0,BOS,5,6,25257,211,1,W
2021-06-12,0,BOS,7,2,24024,189,-5,NW
2021-06-13,0,BOS,18,4,22595,174,-14,NW
2021-06-14,0,BOS,1,2,20070,162,1,W
2021-06-25,0,BOS,3,5,36869,217,2,W
2021-06-26,0,BOS,2,4,36857,202,2,W
2021-06-27,0,BOS,2,9,34504,189,7,W
2021-06-28,0,BOS,5,6,22766,182,1,W
2021-06-29,0,BOS,6,7,25180,211,1,W
2021-06-30,0,BOS,2,6,24616,175,4,W
2021-07-01,0,BOS,1,15,27913,188,14,W
2021-07-09,0,BOS,5,11,32641,224,6,W
2021-07-10,0,BOS,11,2,33202,207,-9,NW
2021-07-11,0,BOS,5,4,32586,215,-1,NW
2021-07-22,0,BOS,4,5,34761,228,1,W
2021-07-23,0,BOS,2,6,34922,206,4,W
2021-07-24,0,BOS,4,3,35136,182,-1,NW
2021-07-25,0,BOS,4,5,32009,170,1,W
2021-07-26,0,BOS,4,5,27142,197,1,W
2021-07-28,1,BOS,4,1,27410,156,-3,NW
2021-07-28,2,BOS,1,4,27783,147,3,W
2021-07-29,0,BOS,13,1,33191,204,-12,NW
2021-08-10,0,BOS,8,4,28356,208,-4,NW
2021-08-11,0,BOS,8,20,30286,197,12,W
2021-08-12,0,BOS,8,1,26803,179,-7,NW
2021-08-13,0,BOS,1,8,28022,185,7,W
2021-08-14,0,BOS,2,16,33118,192,14,W
2021-08-15,0,BOS,2,6,28935,187,4,W
2021-08-20,0,BOS,0,6,30012,193,6,W
2021-08-21,0,BOS,10,1,32495,205,-9,NW
2021-08-23,0,BOS,4,8,27652,224,4,W
2021-08-24,0,BOS,9,11,27986,249,2,W
2021-08-25,0,BOS,9,6,28923,247,-3,NW
2021-08-26,0,BOS,2,12,33746,213,10,W
2021-09-03,0,BOS,5,8,31127,189,3,W
2021-09-04,0,BOS,3,4,33081,189,1,W
2021-09-05,0,BOS,11,5,27578,239,-6,NW
2021-09-06,0,BOS,11,10,26512,294,-1,NW
2021-09-07,0,BOS,12,7,25065,177,-5,NW
2021-09-08,0,BOS,1,2,26649,166,1,W
2021-09-17,0,BOS,1,7,29811,207,6,W
2021-09-18,0,BOS,3,9,30027,189,6,W
2021-09-19,0,BOS,6,8,27010,175,2,W
2021-09-21,0,BOS,3,6,32146,218,3,W
2021-09-22,0,BOS,5,12,30254,222,7,W
2021-09-24,0,BOS,8,3,36026,211,-5,NW
2021-09-25,0,BOS,5,3,36103,213,-2,NW
2021-09-26,0,BOS,6,3,36312,222,-3,NW
2022-04-15,0,BOS,8,4,36266,213,-4,NW
2022-04-16,0,BOS,0,4,34990,165,4,W
2022-04-17,0,BOS,1,8,28858,171,7,W
2022-04-18,0,BOS,8,3,32514,208,-5,NW
2022-04-19,0,BOS,1,2,31640,190,1,W
2022-04-20,0,BOS,6,1,33354,187,-5,NW
2022-04-21,0,BOS,3,2,35792,179,-1,NW
2022-05-03,0,BOS,0,4,29793,143,4,W
2022-05-04,0,BOS,10,5,27679,222,-5,NW
2022-05-05,0,BOS,8,0,29476,175,-8,NW
2022-05-06,0,BOS,4,2,30944,209,-2,NW
2022-05-07,0,BOS,3,1,33026,222,-2,NW
2022-05-08,0,BOS,3,2,28602,201,-1,NW
2022-05-16,0,BOS,3,6,29706,187,3,W
2022-05-17,0,BOS,13,4,27328,192,-9,NW
2022-05-18,0,BOS,1,5,31717,158,4,W
2022-05-19,0,BOS,6,12,29783,218,6,W
2022-05-20,0,BOS,3,7,30842,174,4,W
2022-05-21,0,BOS,5,6,34832,179,1,W
2022-05-22,0,BOS,4,8,33896,198,4,W
2022-05-27,0,BOS,12,8,29251,218,-4,NW
2022-05-28,1,BOS,3,5,26912,178,2,W
2022-05-28,2,BOS,4,2,28491,189,-2,NW
2022-05-29,0,BOS,2,12,35715,207,10,W
2022-05-30,0,BOS,10,0,24809,185,-10,NW
2022-05-31,0,BOS,2,1,28577,184,-1,NW
2022-06-01,0,BOS,1,7,30219,160,6,W
2022-06-14,0,BOS,1,6,32617,163,5,W
2022-06-15,0,BOS,1,10,31877,188,9,W
2022-06-16,0,BOS,4,3,30779,195,-1,NW
2022-06-17,0,BOS,5,6,35251,185,1,W
2022-06-18,0,BOS,11,2,36141,208,-9,NW
2022-06-19,0,BOS,4,6,35989,193,2,W
2022-06-20,0,BOS,2,5,34811,175,3,W
2022-06-21,0,BOS,4,5,29168,173,1,W
2022-06-22,0,BOS,2,6,35180,183,4,W
2022-07-04,0,BOS,0,4,36473,177,4,W
2022-07-05,0,BOS,8,4,31113,219,-4,NW
2022-07-06,0,BOS,7,1,33735,185,-6,NW
2022-07-07,0,BOS,6,5,36876,176,-1,NW
2022-07-08,0,BOS,12,5,36841,231,-7,NW
2022-07-09,0,BOS,5,6,36945,218,1,W
2022-07-10,0,BOS,6,11,37291,212,5,W
2022-07-22,0,BOS,28,5,36796,229,-23,NW
2022-07-23,0,BOS,4,1,35821,189,-3,NW
2022-07-24,0,BOS,8,4,34404,213,-4,NW
2022-07-25,0,BOS,1,3,32529,183,2,W
2022-07-26,0,BOS,8,3,32483,200,-5,NW
2022-07-27,0,BOS,7,6,32919,182,-1,NW
2022-07-28,0,BOS,2,4,32122,153,2,W
2022-07-29,0,BOS,4,1,34193,207,-3,NW
2022-07-30,0,BOS,9,4,35867,229,-5,NW
2022-07-31,0,BOS,2,7,35231,178,5,W
2022-08-09,0,BOS,9,7,34972,253,-2,NW
2022-08-10,0,BOS,8,4,35406,186,-4,NW
2022-08-11,0,BOS,3,4,33927,166,1,W
2022-08-12,0,BOS,2,3,36434,204,1,W
2022-08-13,0,BOS,3,2,36672,194,-1,NW
2022-08-14,0,BOS,0,3,36581,135,3,W
2022-08-23,0,BOS,9,3,30963,198,-6,NW
2022-08-24,0,BOS,3,2,31840,192,-1,NW
2022-08-25,0,BOS,6,5,30527,262,-1,NW
2022-08-26,0,BOS,8,9,30095,210,1,W
2022-08-27,0,BOS,1,5,34036,144,4,W
2022-08-28,0,BOS,12,4,29116,194,-8,NW
2022-09-01,0,BOS,8,9,31340,221,1,W
2022-09-02,0,BOS,1,9,31628,191,8,W
2022-09-03,0,BOS,3,5,31474,192,2,W
2022-09-04,0,BOS,2,5,32422,187,3,W
2022-09-13,0,BOS,7,6,34250,217,-1,NW
2022-09-14,0,BOS,5,3,36581,187,-2,NW
2022-09-16,0,BOS,1,2,33181,158,1,W
2022-09-17,0,BOS,9,0,34925,159,-9,NW
2022-09-18,0,BOS,3,13,31199,212,10,W
2022-09-26,0,BOS,14,8,25634,199,-6,NW
2022-09-27,0,BOS,9,13,30765,237,4,W
2022-09-28,0,BOS,1,3,33073,159,2,W
2022-09-29,0,BOS,3,5,29779,180,2,W
2022-10-03,0,BOS,3,4,26633,155,1,W
2022-10-04,0,BOS,0,6,26477,104,6,W
2022-10-05,0,BOS,3,6,26695,201,3,W
